Haplosufficient_genes	/data/talkowski/Samples/rCNVmap/data/master_annotations/genelists/ExAC_haplosufficient.genes.list
Not_clearly_haplosufficient_genes	/data/talkowski/Samples/rCNVmap/data/master_annotations/genelists/ExAC_notHaplosufficient.genes.list
Constrained_genes	/data/talkowski/Samples/rCNVmap/data/master_annotations/genelists/ExAC_constrained.genes.list
Highly_constrained_genes	/data/talkowski/Samples/rCNVmap/data/master_annotations/genelists/ExAC_highly_constrained.genes.list
Extremely_constrained_genes	/data/talkowski/Samples/rCNVmap/data/master_annotations/genelists/ExAC_extremely_constrained.genes.list
Intolerant_genes	/data/talkowski/Samples/rCNVmap/data/master_annotations/genelists/RVIS_intolerant.genes.list
Highly_intolerant_genes	/data/talkowski/Samples/rCNVmap/data/master_annotations/genelists/RVIS_highly_intolerant.genes.list
Extremely_intolerant_genes	/data/talkowski/Samples/rCNVmap/data/master_annotations/genelists/RVIS_extremely_intolerant.genes.list
Low_confidence_haploinsufficient_genes	/data/talkowski/Samples/rCNVmap/data/master_annotations/genelists/ClinGen_haploinsufficient_low_confidence.genes.list
Medium_confidence_haploinsufficient_genes	/data/talkowski/Samples/rCNVmap/data/master_annotations/genelists/ClinGen_haploinsufficient_medium_confidence.genes.list
High_confidence_haploinsufficient_genes	/data/talkowski/Samples/rCNVmap/data/master_annotations/genelists/ClinGen_haploinsufficient_high_confidence.genes.list
Culture_essential_genes	/data/talkowski/Samples/rCNVmap/data/master_annotations/genelists/Culture_essential.genes.list
FDA_approved_drug_targets	/data/talkowski/Samples/rCNVmap/data/master_annotations/genelists/FDA_drug_targets.genes.list
Autosomal_dominant_disease_genes	/data/talkowski/Samples/rCNVmap/data/master_annotations/genelists/Autosomal_dominant_disease.genes.list
Autosomal_recessive_disease_genes	/data/talkowski/Samples/rCNVmap/data/master_annotations/genelists/Autosomal_recessive_disease.genes.list
Developmental_disorder_associated_genes	/data/talkowski/Samples/rCNVmap/data/master_annotations/genelists/DDD_2017.genes.list
Genes_nearest_GWAS_loci	/data/talkowski/Samples/rCNVmap/data/master_annotations/genelists/GWAS_nearest.genes.list
Germline_disease_associated_genes	/data/talkowski/Samples/rCNVmap/data/master_annotations/genelists/Germline_disease_HPO_associated.genes.list
Cancer_associated_genes	/data/talkowski/Samples/rCNVmap/data/master_annotations/genelists/Cancer_HPO_associated.genes.list
ClinVar_disease_associated_genes	/data/talkowski/Samples/rCNVmap/data/master_annotations/genelists/ClinVar_disease_associated.genes.list
COSMIC_oncogenes	/data/talkowski/Samples/rCNVmap/data/master_annotations/genelists/COSMIC_oncogene.genes.list
COSMIC_cancer_genes	/data/talkowski/Samples/rCNVmap/data/master_annotations/genelists/COSMIC_all.genes.list
COSMIC_tumor_suppressor_genes	/data/talkowski/Samples/rCNVmap/data/master_annotations/genelists/COSMIC_tumor_suppressor.genes.list
Constrained_AND_Highly_Expressed	/data/talkowski/Samples/rCNVmap/data/master_annotations/genelists/Constrained_AND_Highly_Expressed.genes.list
Constrained_OR_Highly_Expressed	/data/talkowski/Samples/rCNVmap/data/master_annotations/genelists/Constrained_OR_Highly_Expressed.genes.list
Constrained_NOT_Highly_Expressed	/data/talkowski/Samples/rCNVmap/data/master_annotations/genelists/Constrained_NOT_Highly_Expressed.genes.list
Highly_Expressed_NOT_Constrained	/data/talkowski/Samples/rCNVmap/data/master_annotations/genelists/Highly_Expressed_NOT_Constrained.genes.list
BRAIN_highly_expressed_genes_union	/data/talkowski/Samples/rCNVmap/data/master_annotations/genelists/BRAIN_MASTER_UNION.Highly_Expressed.genes.list
BRAIN_highly_expressed_genes_intersection	/data/talkowski/Samples/rCNVmap/data/master_annotations/genelists/BRAIN_MASTER_INTERSECTION.Highly_Expressed.genes.list
CELLLINE_highly_expressed_genes_union	/data/talkowski/Samples/rCNVmap/data/master_annotations/genelists/CELLLINE_MASTER_UNION.Highly_Expressed.genes.list
CELLLINE_highly_expressed_genes_intersection	/data/talkowski/Samples/rCNVmap/data/master_annotations/genelists/CELLLINE_MASTER_INTERSECTION.Highly_Expressed.genes.list
DIGESTIVE_highly_expressed_genes_union	/data/talkowski/Samples/rCNVmap/data/master_annotations/genelists/DIGESTIVE_MASTER_UNION.Highly_Expressed.genes.list
DIGESTIVE_highly_expressed_genes_intersection	/data/talkowski/Samples/rCNVmap/data/master_annotations/genelists/DIGESTIVE_MASTER_INTERSECTION.Highly_Expressed.genes.list
ENDOCRINE_highly_expressed_genes_union	/data/talkowski/Samples/rCNVmap/data/master_annotations/genelists/ENDOCRINE_MASTER_UNION.Highly_Expressed.genes.list
ENDOCRINE_highly_expressed_genes_intersection	/data/talkowski/Samples/rCNVmap/data/master_annotations/genelists/ENDOCRINE_MASTER_INTERSECTION.Highly_Expressed.genes.list
FAT_highly_expressed_genes_union	/data/talkowski/Samples/rCNVmap/data/master_annotations/genelists/FAT_MASTER_UNION.Highly_Expressed.genes.list
FAT_highly_expressed_genes_intersection	/data/talkowski/Samples/rCNVmap/data/master_annotations/genelists/FAT_MASTER_INTERSECTION.Highly_Expressed.genes.list
HEADNECK_highly_expressed_genes_union	/data/talkowski/Samples/rCNVmap/data/master_annotations/genelists/HEADNECK_MASTER_UNION.Highly_Expressed.genes.list
HEADNECK_highly_expressed_genes_intersection	/data/talkowski/Samples/rCNVmap/data/master_annotations/genelists/HEADNECK_MASTER_INTERSECTION.Highly_Expressed.genes.list
HEART_highly_expressed_genes_union	/data/talkowski/Samples/rCNVmap/data/master_annotations/genelists/HEART_MASTER_UNION.Highly_Expressed.genes.list
HEART_highly_expressed_genes_intersection	/data/talkowski/Samples/rCNVmap/data/master_annotations/genelists/HEART_MASTER_INTERSECTION.Highly_Expressed.genes.list
IMMUNE_highly_expressed_genes_union	/data/talkowski/Samples/rCNVmap/data/master_annotations/genelists/IMMUNE_MASTER_UNION.Highly_Expressed.genes.list
IMMUNE_highly_expressed_genes_intersection	/data/talkowski/Samples/rCNVmap/data/master_annotations/genelists/IMMUNE_MASTER_INTERSECTION.Highly_Expressed.genes.list
LUNG_highly_expressed_genes_union	/data/talkowski/Samples/rCNVmap/data/master_annotations/genelists/LUNG_MASTER_UNION.Highly_Expressed.genes.list
LUNG_highly_expressed_genes_intersection	/data/talkowski/Samples/rCNVmap/data/master_annotations/genelists/LUNG_MASTER_INTERSECTION.Highly_Expressed.genes.list
MUSCLE_highly_expressed_genes_union	/data/talkowski/Samples/rCNVmap/data/master_annotations/genelists/MUSCLE_MASTER_UNION.Highly_Expressed.genes.list
MUSCLE_highly_expressed_genes_intersection	/data/talkowski/Samples/rCNVmap/data/master_annotations/genelists/MUSCLE_MASTER_INTERSECTION.Highly_Expressed.genes.list
RENAL_highly_expressed_genes_union	/data/talkowski/Samples/rCNVmap/data/master_annotations/genelists/RENAL_MASTER_UNION.Highly_Expressed.genes.list
RENAL_highly_expressed_genes_intersection	/data/talkowski/Samples/rCNVmap/data/master_annotations/genelists/RENAL_MASTER_INTERSECTION.Highly_Expressed.genes.list
REPRO_highly_expressed_genes_union	/data/talkowski/Samples/rCNVmap/data/master_annotations/genelists/REPRO_MASTER_UNION.Highly_Expressed.genes.list
REPRO_highly_expressed_genes_intersection	/data/talkowski/Samples/rCNVmap/data/master_annotations/genelists/REPRO_MASTER_INTERSECTION.Highly_Expressed.genes.list
SKIN_highly_expressed_genes_union	/data/talkowski/Samples/rCNVmap/data/master_annotations/genelists/SKIN_MASTER_UNION.Highly_Expressed.genes.list
SKIN_highly_expressed_genes_intersection	/data/talkowski/Samples/rCNVmap/data/master_annotations/genelists/SKIN_MASTER_INTERSECTION.Highly_Expressed.genes.list