DNA_repeats	/data/talkowski/Samples/rCNVmap/data/master_annotations/noncoding/RepeatMasker_DNA.elements.bed
Evolutionarily_conserved_elements_GERP	/data/talkowski/Samples/rCNVmap/data/master_annotations/noncoding/evolutionarilyConserved_GERP.elements.bed
Evolutionarily_conserved_elements_PhyloP	/data/talkowski/Samples/rCNVmap/data/master_annotations/noncoding/evolutionarilyConserved_PhyloP.elements.bed
FIREs_All_Cell_Lines	/data/talkowski/Samples/rCNVmap/data/master_annotations/noncoding/FIREs_AllCellLines.elements.bed
FIREs_All_Primary_Tissues	/data/talkowski/Samples/rCNVmap/data/master_annotations/noncoding/FIREs_AllPrimaryTissues.elements.bed
FIREs_All_Sources	/data/talkowski/Samples/rCNVmap/data/master_annotations/noncoding/FIREs_AllSources.elements.bed
Highly_conserved_ChromHMM_Active_Transcription_Start_Site_Downstream_Flanks	/data/talkowski/Samples/rCNVmap/data/master_annotations/noncoding/ChromHMM_Flanking_TSS_Downstream_highlyConserved.elements.bed
Highly_conserved_ChromHMM_Active_Transcription_Start_Site_Flanks	/data/talkowski/Samples/rCNVmap/data/master_annotations/noncoding/ChromHMM_Flanking_TSS_highlyConserved.elements.bed
Highly_conserved_ChromHMM_Active_Transcription_Start_Site_Upstream_Flanks	/data/talkowski/Samples/rCNVmap/data/master_annotations/noncoding/ChromHMM_Flanking_TSS_Upstream_highlyConserved.elements.bed
Highly_conserved_ChromHMM_Active_Transcription_Start_Sites	/data/talkowski/Samples/rCNVmap/data/master_annotations/noncoding/ChromHMM_Active_TSS_highlyConserved.elements.bed
Highly_conserved_ChromHMM_BivalentPoised_Transcription_Start_Sites	/data/talkowski/Samples/rCNVmap/data/master_annotations/noncoding/ChromHMM_Bivalent_Poised_TSS_highlyConserved.elements.bed
Highly_conserved_ChromHMM_Strong_Transcribed_Elements	/data/talkowski/Samples/rCNVmap/data/master_annotations/noncoding/ChromHMM_Strong_Transcription_highlyConserved.elements.bed
Highly_conserved_ChromHMM_Weak_Polycomb_Repressed_Elements	/data/talkowski/Samples/rCNVmap/data/master_annotations/noncoding/ChromHMM_Weak_Repressed_PolyComb_highlyConserved.elements.bed
Highly_conserved_ChromHMM_Weak_Transcribed_Elements	/data/talkowski/Samples/rCNVmap/data/master_annotations/noncoding/ChromHMM_Weak_Transcription_highlyConserved.elements.bed
Conserved_ChromHMM_Active_Transcription_Start_Site_Downstream_Flanks	/data/talkowski/Samples/rCNVmap/data/master_annotations/noncoding/ChromHMM_Flanking_TSS_Downstream_conserved.elements.bed
Conserved_ChromHMM_Active_Transcription_Start_Site_Flanks	/data/talkowski/Samples/rCNVmap/data/master_annotations/noncoding/ChromHMM_Flanking_TSS_conserved.elements.bed
Conserved_ChromHMM_Active_Transcription_Start_Site_Upstream_Flanks	/data/talkowski/Samples/rCNVmap/data/master_annotations/noncoding/ChromHMM_Flanking_TSS_Upstream_conserved.elements.bed
Conserved_ChromHMM_Active_Transcription_Start_Sites	/data/talkowski/Samples/rCNVmap/data/master_annotations/noncoding/ChromHMM_Active_TSS_conserved.elements.bed
Conserved_ChromHMM_BivalentPoised_Transcription_Start_Sites	/data/talkowski/Samples/rCNVmap/data/master_annotations/noncoding/ChromHMM_Bivalent_Poised_TSS_conserved.elements.bed
Conserved_ChromHMM_Strong_Transcribed_Elements	/data/talkowski/Samples/rCNVmap/data/master_annotations/noncoding/ChromHMM_Strong_Transcription_conserved.elements.bed
Conserved_ChromHMM_Weak_Polycomb_Repressed_Elements	/data/talkowski/Samples/rCNVmap/data/master_annotations/noncoding/ChromHMM_Weak_Repressed_PolyComb_conserved.elements.bed
Conserved_ChromHMM_Weak_Transcribed_Elements	/data/talkowski/Samples/rCNVmap/data/master_annotations/noncoding/ChromHMM_Weak_Transcription_conserved.elements.bed
Conserved_ChromHMM_ZNF_Genes_&_Repeats	/data/talkowski/Samples/rCNVmap/data/master_annotations/noncoding/ChromHMM_ZNF_Genes_Repeats_conserved.elements.bed
Conserved_ChromHMM_Weak_Enhancers	/data/talkowski/Samples/rCNVmap/data/master_annotations/noncoding/ChromHMM_Weak_Enhancer_conserved.elements.bed
Highly_conserved_ChromHMM_Weak_Enhancers	/data/talkowski/Samples/rCNVmap/data/master_annotations/noncoding/ChromHMM_Weak_Enhancer_highlyConserved.elements.bed
Highly_conserved_ChromHMM_ZNF_Genes_&_Repeats	/data/talkowski/Samples/rCNVmap/data/master_annotations/noncoding/ChromHMM_ZNF_Genes_Repeats_highlyConserved.elements.bed
LINEs	/data/talkowski/Samples/rCNVmap/data/master_annotations/noncoding/RepeatMasker_LINE.elements.bed
Low_complexity_repeats	/data/talkowski/Samples/rCNVmap/data/master_annotations/noncoding/RepeatMasker_Low_complexity.elements.bed
LTRs	/data/talkowski/Samples/rCNVmap/data/master_annotations/noncoding/RepeatMasker_LTR.elements.bed
Rolling_circle_repeats	/data/talkowski/Samples/rCNVmap/data/master_annotations/noncoding/RepeatMasker_RC.elements.bed
Satellites	/data/talkowski/Samples/rCNVmap/data/master_annotations/noncoding/RepeatMasker_Satellite.elements.bed
Segmental_Duplications	/data/talkowski/Samples/rCNVmap/data/master_annotations/noncoding/SegDups.elements.bed
Simple_repeats	/data/talkowski/Samples/rCNVmap/data/master_annotations/noncoding/RepeatMasker_Simple_repeat.elements.bed
SINEs	/data/talkowski/Samples/rCNVmap/data/master_annotations/noncoding/RepeatMasker_SINE.elements.bed
Recombination_hotspots	/data/talkowski/Samples/rCNVmap/data/master_annotations/noncoding/Recombination_Hotspots.elements.bed
Strong_TFBS_All_TFs	/data/talkowski/Samples/rCNVmap/data/master_annotations/noncoding/StrongTFBS_union.elements.bed
Strong_TFBS_ATF3	/data/talkowski/Samples/rCNVmap/data/master_annotations/noncoding/StrongTFBS_ATF3.elements.bed
Strong_TFBS_BCL3	/data/talkowski/Samples/rCNVmap/data/master_annotations/noncoding/StrongTFBS_BCL3.elements.bed
Strong_TFBS_BHLHE40	/data/talkowski/Samples/rCNVmap/data/master_annotations/noncoding/StrongTFBS_BHLHE40.elements.bed
Strong_TFBS_BRCA1	/data/talkowski/Samples/rCNVmap/data/master_annotations/noncoding/StrongTFBS_BRCA1.elements.bed
Strong_TFBS_CEBPB	/data/talkowski/Samples/rCNVmap/data/master_annotations/noncoding/StrongTFBS_CEBPB.elements.bed
Strong_TFBS_CHD1	/data/talkowski/Samples/rCNVmap/data/master_annotations/noncoding/StrongTFBS_CHD1.elements.bed
Strong_TFBS_CHD2	/data/talkowski/Samples/rCNVmap/data/master_annotations/noncoding/StrongTFBS_CHD2.elements.bed
Strong_TFBS_CTCF	/data/talkowski/Samples/rCNVmap/data/master_annotations/noncoding/StrongTFBS_CTCF.elements.bed
Strong_TFBS_E2F1	/data/talkowski/Samples/rCNVmap/data/master_annotations/noncoding/StrongTFBS_E2F1.elements.bed
Strong_TFBS_E2F4	/data/talkowski/Samples/rCNVmap/data/master_annotations/noncoding/StrongTFBS_E2F4.elements.bed
Strong_TFBS_E2F6	/data/talkowski/Samples/rCNVmap/data/master_annotations/noncoding/StrongTFBS_E2F6.elements.bed
Strong_TFBS_EGR1	/data/talkowski/Samples/rCNVmap/data/master_annotations/noncoding/StrongTFBS_EGR1.elements.bed
Strong_TFBS_ELF1	/data/talkowski/Samples/rCNVmap/data/master_annotations/noncoding/StrongTFBS_ELF1.elements.bed
Strong_TFBS_ELK1	/data/talkowski/Samples/rCNVmap/data/master_annotations/noncoding/StrongTFBS_ELK1.elements.bed
Strong_TFBS_EP300	/data/talkowski/Samples/rCNVmap/data/master_annotations/noncoding/StrongTFBS_EP300.elements.bed
Strong_TFBS_ESR1	/data/talkowski/Samples/rCNVmap/data/master_annotations/noncoding/StrongTFBS_ESR1.elements.bed
Strong_TFBS_ETS1	/data/talkowski/Samples/rCNVmap/data/master_annotations/noncoding/StrongTFBS_ETS1.elements.bed
Strong_TFBS_EZH2	/data/talkowski/Samples/rCNVmap/data/master_annotations/noncoding/StrongTFBS_EZH2.elements.bed
Strong_TFBS_FOS	/data/talkowski/Samples/rCNVmap/data/master_annotations/noncoding/StrongTFBS_FOS.elements.bed
Strong_TFBS_FOXA1	/data/talkowski/Samples/rCNVmap/data/master_annotations/noncoding/StrongTFBS_FOXA1.elements.bed
Strong_TFBS_GABPA	/data/talkowski/Samples/rCNVmap/data/master_annotations/noncoding/StrongTFBS_GABPA.elements.bed
Strong_TFBS_GATA1	/data/talkowski/Samples/rCNVmap/data/master_annotations/noncoding/StrongTFBS_GATA1.elements.bed
Strong_TFBS_GATA2	/data/talkowski/Samples/rCNVmap/data/master_annotations/noncoding/StrongTFBS_GATA2.elements.bed
Strong_TFBS_GATA3	/data/talkowski/Samples/rCNVmap/data/master_annotations/noncoding/StrongTFBS_GATA3.elements.bed
Strong_TFBS_GTF2F1	/data/talkowski/Samples/rCNVmap/data/master_annotations/noncoding/StrongTFBS_GTF2F1.elements.bed
Strong_TFBS_HDAC2	/data/talkowski/Samples/rCNVmap/data/master_annotations/noncoding/StrongTFBS_HDAC2.elements.bed
Strong_TFBS_IRF1	/data/talkowski/Samples/rCNVmap/data/master_annotations/noncoding/StrongTFBS_IRF1.elements.bed
Strong_TFBS_JUN	/data/talkowski/Samples/rCNVmap/data/master_annotations/noncoding/StrongTFBS_JUN.elements.bed
Strong_TFBS_JUND	/data/talkowski/Samples/rCNVmap/data/master_annotations/noncoding/StrongTFBS_JUND.elements.bed
Strong_TFBS_KAP1	/data/talkowski/Samples/rCNVmap/data/master_annotations/noncoding/StrongTFBS_KAP1.elements.bed
Strong_TFBS_MAFK	/data/talkowski/Samples/rCNVmap/data/master_annotations/noncoding/StrongTFBS_MAFK.elements.bed
Strong_TFBS_MAX	/data/talkowski/Samples/rCNVmap/data/master_annotations/noncoding/StrongTFBS_MAX.elements.bed
Strong_TFBS_MAZ	/data/talkowski/Samples/rCNVmap/data/master_annotations/noncoding/StrongTFBS_MAZ.elements.bed
Strong_TFBS_MXI1	/data/talkowski/Samples/rCNVmap/data/master_annotations/noncoding/StrongTFBS_MXI1.elements.bed
Strong_TFBS_MYC	/data/talkowski/Samples/rCNVmap/data/master_annotations/noncoding/StrongTFBS_MYC.elements.bed
Strong_TFBS_NFYA	/data/talkowski/Samples/rCNVmap/data/master_annotations/noncoding/StrongTFBS_NFYA.elements.bed
Strong_TFBS_NFYB	/data/talkowski/Samples/rCNVmap/data/master_annotations/noncoding/StrongTFBS_NFYB.elements.bed
Strong_TFBS_NR2C2	/data/talkowski/Samples/rCNVmap/data/master_annotations/noncoding/StrongTFBS_NR2C2.elements.bed
Strong_TFBS_NR3C1	/data/talkowski/Samples/rCNVmap/data/master_annotations/noncoding/StrongTFBS_NR3C1.elements.bed
Strong_TFBS_NRF1	/data/talkowski/Samples/rCNVmap/data/master_annotations/noncoding/StrongTFBS_NRF1.elements.bed
Strong_TFBS_PAX5	/data/talkowski/Samples/rCNVmap/data/master_annotations/noncoding/StrongTFBS_PAX5.elements.bed
Strong_TFBS_POLR2A	/data/talkowski/Samples/rCNVmap/data/master_annotations/noncoding/StrongTFBS_POLR2A.elements.bed
Strong_TFBS_RAD21	/data/talkowski/Samples/rCNVmap/data/master_annotations/noncoding/StrongTFBS_RAD21.elements.bed
Strong_TFBS_RCOR1	/data/talkowski/Samples/rCNVmap/data/master_annotations/noncoding/StrongTFBS_RCOR1.elements.bed
Strong_TFBS_RELA	/data/talkowski/Samples/rCNVmap/data/master_annotations/noncoding/StrongTFBS_RELA.elements.bed
Strong_TFBS_REST	/data/talkowski/Samples/rCNVmap/data/master_annotations/noncoding/StrongTFBS_REST.elements.bed
Strong_TFBS_RFX5	/data/talkowski/Samples/rCNVmap/data/master_annotations/noncoding/StrongTFBS_RFX5.elements.bed
Strong_TFBS_RXRA	/data/talkowski/Samples/rCNVmap/data/master_annotations/noncoding/StrongTFBS_RXRA.elements.bed
Strong_TFBS_SETDB1	/data/talkowski/Samples/rCNVmap/data/master_annotations/noncoding/StrongTFBS_SETDB1.elements.bed
Strong_TFBS_SIN3AK20	/data/talkowski/Samples/rCNVmap/data/master_annotations/noncoding/StrongTFBS_SIN3AK20.elements.bed
Strong_TFBS_SIX5	/data/talkowski/Samples/rCNVmap/data/master_annotations/noncoding/StrongTFBS_SIX5.elements.bed
Strong_TFBS_SMC3	/data/talkowski/Samples/rCNVmap/data/master_annotations/noncoding/StrongTFBS_SMC3.elements.bed
Strong_TFBS_SP1	/data/talkowski/Samples/rCNVmap/data/master_annotations/noncoding/StrongTFBS_SP1.elements.bed
Strong_TFBS_SP2	/data/talkowski/Samples/rCNVmap/data/master_annotations/noncoding/StrongTFBS_SP2.elements.bed
Strong_TFBS_SPI1	/data/talkowski/Samples/rCNVmap/data/master_annotations/noncoding/StrongTFBS_SPI1.elements.bed
Strong_TFBS_SRF	/data/talkowski/Samples/rCNVmap/data/master_annotations/noncoding/StrongTFBS_SRF.elements.bed
Strong_TFBS_STAT1	/data/talkowski/Samples/rCNVmap/data/master_annotations/noncoding/StrongTFBS_STAT1.elements.bed
Strong_TFBS_STAT3	/data/talkowski/Samples/rCNVmap/data/master_annotations/noncoding/StrongTFBS_STAT3.elements.bed
Strong_TFBS_TAF1	/data/talkowski/Samples/rCNVmap/data/master_annotations/noncoding/StrongTFBS_TAF1.elements.bed
Strong_TFBS_TBL1XR1	/data/talkowski/Samples/rCNVmap/data/master_annotations/noncoding/StrongTFBS_TBL1XR1.elements.bed
Strong_TFBS_TBP	/data/talkowski/Samples/rCNVmap/data/master_annotations/noncoding/StrongTFBS_TBP.elements.bed
Strong_TFBS_TCF12	/data/talkowski/Samples/rCNVmap/data/master_annotations/noncoding/StrongTFBS_TCF12.elements.bed
Strong_TFBS_TCF7L2	/data/talkowski/Samples/rCNVmap/data/master_annotations/noncoding/StrongTFBS_TCF7L2.elements.bed
Strong_TFBS_TEAD4	/data/talkowski/Samples/rCNVmap/data/master_annotations/noncoding/StrongTFBS_TEAD4.elements.bed
Strong_TFBS_USF1	/data/talkowski/Samples/rCNVmap/data/master_annotations/noncoding/StrongTFBS_USF1.elements.bed
Strong_TFBS_USF2	/data/talkowski/Samples/rCNVmap/data/master_annotations/noncoding/StrongTFBS_USF2.elements.bed
Strong_TFBS_YY1	/data/talkowski/Samples/rCNVmap/data/master_annotations/noncoding/StrongTFBS_YY1.elements.bed
Strong_TFBS_ZBTB33	/data/talkowski/Samples/rCNVmap/data/master_annotations/noncoding/StrongTFBS_ZBTB33.elements.bed
Strong_TFBS_ZNF143	/data/talkowski/Samples/rCNVmap/data/master_annotations/noncoding/StrongTFBS_ZNF143.elements.bed
Strong_TFBS_ZNF274	/data/talkowski/Samples/rCNVmap/data/master_annotations/noncoding/StrongTFBS_ZNF274.elements.bed
TBRs_All_Cell_Lines	/data/talkowski/Samples/rCNVmap/data/master_annotations/noncoding/TBRs_AllCellLines.elements.bed
TBRs_All_Primary_Tissues	/data/talkowski/Samples/rCNVmap/data/master_annotations/noncoding/TBRs_AllPrimaryTissues.elements.bed
TBRs_All_Sources	/data/talkowski/Samples/rCNVmap/data/master_annotations/noncoding/TBRs_AllSources.elements.bed
TFBS_All_TFs	/data/talkowski/Samples/rCNVmap/data/master_annotations/noncoding/TFBS_union.elements.bed
TFBS_ATF3	/data/talkowski/Samples/rCNVmap/data/master_annotations/noncoding/TFBS_ATF3.elements.bed
TFBS_BCL3	/data/talkowski/Samples/rCNVmap/data/master_annotations/noncoding/TFBS_BCL3.elements.bed
TFBS_BHLHE40	/data/talkowski/Samples/rCNVmap/data/master_annotations/noncoding/TFBS_BHLHE40.elements.bed
TFBS_BRCA1	/data/talkowski/Samples/rCNVmap/data/master_annotations/noncoding/TFBS_BRCA1.elements.bed
TFBS_CEBPB	/data/talkowski/Samples/rCNVmap/data/master_annotations/noncoding/TFBS_CEBPB.elements.bed
TFBS_CHD1	/data/talkowski/Samples/rCNVmap/data/master_annotations/noncoding/TFBS_CHD1.elements.bed
TFBS_CHD2	/data/talkowski/Samples/rCNVmap/data/master_annotations/noncoding/TFBS_CHD2.elements.bed
TFBS_CTCF	/data/talkowski/Samples/rCNVmap/data/master_annotations/noncoding/TFBS_CTCF.elements.bed
TFBS_E2F1	/data/talkowski/Samples/rCNVmap/data/master_annotations/noncoding/TFBS_E2F1.elements.bed
TFBS_E2F4	/data/talkowski/Samples/rCNVmap/data/master_annotations/noncoding/TFBS_E2F4.elements.bed
TFBS_E2F6	/data/talkowski/Samples/rCNVmap/data/master_annotations/noncoding/TFBS_E2F6.elements.bed
TFBS_EGR1	/data/talkowski/Samples/rCNVmap/data/master_annotations/noncoding/TFBS_EGR1.elements.bed
TFBS_ELF1	/data/talkowski/Samples/rCNVmap/data/master_annotations/noncoding/TFBS_ELF1.elements.bed
TFBS_ELK1	/data/talkowski/Samples/rCNVmap/data/master_annotations/noncoding/TFBS_ELK1.elements.bed
TFBS_EP300	/data/talkowski/Samples/rCNVmap/data/master_annotations/noncoding/TFBS_EP300.elements.bed
TFBS_ESR1	/data/talkowski/Samples/rCNVmap/data/master_annotations/noncoding/TFBS_ESR1.elements.bed
TFBS_ETS1	/data/talkowski/Samples/rCNVmap/data/master_annotations/noncoding/TFBS_ETS1.elements.bed
TFBS_EZH2	/data/talkowski/Samples/rCNVmap/data/master_annotations/noncoding/TFBS_EZH2.elements.bed
TFBS_FOS	/data/talkowski/Samples/rCNVmap/data/master_annotations/noncoding/TFBS_FOS.elements.bed
TFBS_FOXA1	/data/talkowski/Samples/rCNVmap/data/master_annotations/noncoding/TFBS_FOXA1.elements.bed
TFBS_GABPA	/data/talkowski/Samples/rCNVmap/data/master_annotations/noncoding/TFBS_GABPA.elements.bed
TFBS_GATA1	/data/talkowski/Samples/rCNVmap/data/master_annotations/noncoding/TFBS_GATA1.elements.bed
TFBS_GATA2	/data/talkowski/Samples/rCNVmap/data/master_annotations/noncoding/TFBS_GATA2.elements.bed
TFBS_GATA3	/data/talkowski/Samples/rCNVmap/data/master_annotations/noncoding/TFBS_GATA3.elements.bed
TFBS_GTF2F1	/data/talkowski/Samples/rCNVmap/data/master_annotations/noncoding/TFBS_GTF2F1.elements.bed
TFBS_HDAC2	/data/talkowski/Samples/rCNVmap/data/master_annotations/noncoding/TFBS_HDAC2.elements.bed
TFBS_IRF1	/data/talkowski/Samples/rCNVmap/data/master_annotations/noncoding/TFBS_IRF1.elements.bed
TFBS_JUN	/data/talkowski/Samples/rCNVmap/data/master_annotations/noncoding/TFBS_JUN.elements.bed
TFBS_JUND	/data/talkowski/Samples/rCNVmap/data/master_annotations/noncoding/TFBS_JUND.elements.bed
TFBS_KAP1	/data/talkowski/Samples/rCNVmap/data/master_annotations/noncoding/TFBS_KAP1.elements.bed
TFBS_MAFK	/data/talkowski/Samples/rCNVmap/data/master_annotations/noncoding/TFBS_MAFK.elements.bed
TFBS_MAX	/data/talkowski/Samples/rCNVmap/data/master_annotations/noncoding/TFBS_MAX.elements.bed
TFBS_MAZ	/data/talkowski/Samples/rCNVmap/data/master_annotations/noncoding/TFBS_MAZ.elements.bed
TFBS_MXI1	/data/talkowski/Samples/rCNVmap/data/master_annotations/noncoding/TFBS_MXI1.elements.bed
TFBS_MYC	/data/talkowski/Samples/rCNVmap/data/master_annotations/noncoding/TFBS_MYC.elements.bed
TFBS_NFYA	/data/talkowski/Samples/rCNVmap/data/master_annotations/noncoding/TFBS_NFYA.elements.bed
TFBS_NFYB	/data/talkowski/Samples/rCNVmap/data/master_annotations/noncoding/TFBS_NFYB.elements.bed
TFBS_NR2C2	/data/talkowski/Samples/rCNVmap/data/master_annotations/noncoding/TFBS_NR2C2.elements.bed
TFBS_NR3C1	/data/talkowski/Samples/rCNVmap/data/master_annotations/noncoding/TFBS_NR3C1.elements.bed
TFBS_NRF1	/data/talkowski/Samples/rCNVmap/data/master_annotations/noncoding/TFBS_NRF1.elements.bed
TFBS_PAX5	/data/talkowski/Samples/rCNVmap/data/master_annotations/noncoding/TFBS_PAX5.elements.bed
TFBS_POLR2A	/data/talkowski/Samples/rCNVmap/data/master_annotations/noncoding/TFBS_POLR2A.elements.bed
TFBS_RAD21	/data/talkowski/Samples/rCNVmap/data/master_annotations/noncoding/TFBS_RAD21.elements.bed
TFBS_RCOR1	/data/talkowski/Samples/rCNVmap/data/master_annotations/noncoding/TFBS_RCOR1.elements.bed
TFBS_RELA	/data/talkowski/Samples/rCNVmap/data/master_annotations/noncoding/TFBS_RELA.elements.bed
TFBS_REST	/data/talkowski/Samples/rCNVmap/data/master_annotations/noncoding/TFBS_REST.elements.bed
TFBS_RFX5	/data/talkowski/Samples/rCNVmap/data/master_annotations/noncoding/TFBS_RFX5.elements.bed
TFBS_RXRA	/data/talkowski/Samples/rCNVmap/data/master_annotations/noncoding/TFBS_RXRA.elements.bed
TFBS_SETDB1	/data/talkowski/Samples/rCNVmap/data/master_annotations/noncoding/TFBS_SETDB1.elements.bed
TFBS_SIN3AK20	/data/talkowski/Samples/rCNVmap/data/master_annotations/noncoding/TFBS_SIN3AK20.elements.bed
TFBS_SIX5	/data/talkowski/Samples/rCNVmap/data/master_annotations/noncoding/TFBS_SIX5.elements.bed
TFBS_SMC3	/data/talkowski/Samples/rCNVmap/data/master_annotations/noncoding/TFBS_SMC3.elements.bed
TFBS_SP1	/data/talkowski/Samples/rCNVmap/data/master_annotations/noncoding/TFBS_SP1.elements.bed
TFBS_SP2	/data/talkowski/Samples/rCNVmap/data/master_annotations/noncoding/TFBS_SP2.elements.bed
TFBS_SPI1	/data/talkowski/Samples/rCNVmap/data/master_annotations/noncoding/TFBS_SPI1.elements.bed
TFBS_SRF	/data/talkowski/Samples/rCNVmap/data/master_annotations/noncoding/TFBS_SRF.elements.bed
TFBS_STAT1	/data/talkowski/Samples/rCNVmap/data/master_annotations/noncoding/TFBS_STAT1.elements.bed
TFBS_STAT3	/data/talkowski/Samples/rCNVmap/data/master_annotations/noncoding/TFBS_STAT3.elements.bed
TFBS_TAF1	/data/talkowski/Samples/rCNVmap/data/master_annotations/noncoding/TFBS_TAF1.elements.bed
TFBS_TBL1XR1	/data/talkowski/Samples/rCNVmap/data/master_annotations/noncoding/TFBS_TBL1XR1.elements.bed
TFBS_TBP	/data/talkowski/Samples/rCNVmap/data/master_annotations/noncoding/TFBS_TBP.elements.bed
TFBS_TCF12	/data/talkowski/Samples/rCNVmap/data/master_annotations/noncoding/TFBS_TCF12.elements.bed
TFBS_TCF7L2	/data/talkowski/Samples/rCNVmap/data/master_annotations/noncoding/TFBS_TCF7L2.elements.bed
TFBS_TEAD4	/data/talkowski/Samples/rCNVmap/data/master_annotations/noncoding/TFBS_TEAD4.elements.bed
TFBS_USF1	/data/talkowski/Samples/rCNVmap/data/master_annotations/noncoding/TFBS_USF1.elements.bed
TFBS_USF2	/data/talkowski/Samples/rCNVmap/data/master_annotations/noncoding/TFBS_USF2.elements.bed
TFBS_YY1	/data/talkowski/Samples/rCNVmap/data/master_annotations/noncoding/TFBS_YY1.elements.bed
TFBS_ZBTB33	/data/talkowski/Samples/rCNVmap/data/master_annotations/noncoding/TFBS_ZBTB33.elements.bed
TFBS_ZNF143	/data/talkowski/Samples/rCNVmap/data/master_annotations/noncoding/TFBS_ZNF143.elements.bed
TFBS_ZNF274	/data/talkowski/Samples/rCNVmap/data/master_annotations/noncoding/TFBS_ZNF274.elements.bed
Ultraconserved_elements_UCEs	/data/talkowski/Samples/rCNVmap/data/master_annotations/noncoding/UCEs_McCole.elements.bed
BRAIN_ChromHMM_ActiveTSS	/data/talkowski/Samples/rCNVmap/data/master_annotations/noncoding/BRAIN_MASTER.ChromHMM_ActiveTSS.elements.bed
DIGESTIVE_ChromHMM_ActiveTSS	/data/talkowski/Samples/rCNVmap/data/master_annotations/noncoding/DIGESTIVE_MASTER.ChromHMM_ActiveTSS.elements.bed
EMBRYO_ChromHMM_ActiveTSS	/data/talkowski/Samples/rCNVmap/data/master_annotations/noncoding/EMBRYO_MASTER.ChromHMM_ActiveTSS.elements.bed
ENDOCRINE_ChromHMM_ActiveTSS	/data/talkowski/Samples/rCNVmap/data/master_annotations/noncoding/ENDOCRINE_MASTER.ChromHMM_ActiveTSS.elements.bed
FAT_ChromHMM_ActiveTSS	/data/talkowski/Samples/rCNVmap/data/master_annotations/noncoding/FAT_MASTER.ChromHMM_ActiveTSS.elements.bed
HEADNECK_ChromHMM_ActiveTSS	/data/talkowski/Samples/rCNVmap/data/master_annotations/noncoding/HEADNECK_MASTER.ChromHMM_ActiveTSS.elements.bed
HEART_ChromHMM_ActiveTSS	/data/talkowski/Samples/rCNVmap/data/master_annotations/noncoding/HEART_MASTER.ChromHMM_ActiveTSS.elements.bed
IMMUNE_ChromHMM_ActiveTSS	/data/talkowski/Samples/rCNVmap/data/master_annotations/noncoding/IMMUNE_MASTER.ChromHMM_ActiveTSS.elements.bed
LUNG_ChromHMM_ActiveTSS	/data/talkowski/Samples/rCNVmap/data/master_annotations/noncoding/LUNG_MASTER.ChromHMM_ActiveTSS.elements.bed
MUSCLE_ChromHMM_ActiveTSS	/data/talkowski/Samples/rCNVmap/data/master_annotations/noncoding/MUSCLE_MASTER.ChromHMM_ActiveTSS.elements.bed
REPRO_ChromHMM_ActiveTSS	/data/talkowski/Samples/rCNVmap/data/master_annotations/noncoding/REPRO_MASTER.ChromHMM_ActiveTSS.elements.bed
SKELETAL_ChromHMM_ActiveTSS	/data/talkowski/Samples/rCNVmap/data/master_annotations/noncoding/SKELETAL_MASTER.ChromHMM_ActiveTSS.elements.bed
SKIN_ChromHMM_ActiveTSS	/data/talkowski/Samples/rCNVmap/data/master_annotations/noncoding/SKIN_MASTER.ChromHMM_ActiveTSS.elements.bed
BRAIN_ChromHMM_ActiveTSSFlanks	/data/talkowski/Samples/rCNVmap/data/master_annotations/noncoding/BRAIN_MASTER.ChromHMM_ActiveTSSFlanks.elements.bed
DIGESTIVE_ChromHMM_ActiveTSSFlanks	/data/talkowski/Samples/rCNVmap/data/master_annotations/noncoding/DIGESTIVE_MASTER.ChromHMM_ActiveTSSFlanks.elements.bed
EMBRYO_ChromHMM_ActiveTSSFlanks	/data/talkowski/Samples/rCNVmap/data/master_annotations/noncoding/EMBRYO_MASTER.ChromHMM_ActiveTSSFlanks.elements.bed
ENDOCRINE_ChromHMM_ActiveTSSFlanks	/data/talkowski/Samples/rCNVmap/data/master_annotations/noncoding/ENDOCRINE_MASTER.ChromHMM_ActiveTSSFlanks.elements.bed
FAT_ChromHMM_ActiveTSSFlanks	/data/talkowski/Samples/rCNVmap/data/master_annotations/noncoding/FAT_MASTER.ChromHMM_ActiveTSSFlanks.elements.bed
HEADNECK_ChromHMM_ActiveTSSFlanks	/data/talkowski/Samples/rCNVmap/data/master_annotations/noncoding/HEADNECK_MASTER.ChromHMM_ActiveTSSFlanks.elements.bed
HEART_ChromHMM_ActiveTSSFlanks	/data/talkowski/Samples/rCNVmap/data/master_annotations/noncoding/HEART_MASTER.ChromHMM_ActiveTSSFlanks.elements.bed
IMMUNE_ChromHMM_ActiveTSSFlanks	/data/talkowski/Samples/rCNVmap/data/master_annotations/noncoding/IMMUNE_MASTER.ChromHMM_ActiveTSSFlanks.elements.bed
LUNG_ChromHMM_ActiveTSSFlanks	/data/talkowski/Samples/rCNVmap/data/master_annotations/noncoding/LUNG_MASTER.ChromHMM_ActiveTSSFlanks.elements.bed
MUSCLE_ChromHMM_ActiveTSSFlanks	/data/talkowski/Samples/rCNVmap/data/master_annotations/noncoding/MUSCLE_MASTER.ChromHMM_ActiveTSSFlanks.elements.bed
REPRO_ChromHMM_ActiveTSSFlanks	/data/talkowski/Samples/rCNVmap/data/master_annotations/noncoding/REPRO_MASTER.ChromHMM_ActiveTSSFlanks.elements.bed
SKELETAL_ChromHMM_ActiveTSSFlanks	/data/talkowski/Samples/rCNVmap/data/master_annotations/noncoding/SKELETAL_MASTER.ChromHMM_ActiveTSSFlanks.elements.bed
SKIN_ChromHMM_ActiveTSSFlanks	/data/talkowski/Samples/rCNVmap/data/master_annotations/noncoding/SKIN_MASTER.ChromHMM_ActiveTSSFlanks.elements.bed
BRAIN_ChromHMM_BivalentPoisedTSS	/data/talkowski/Samples/rCNVmap/data/master_annotations/noncoding/BRAIN_MASTER.ChromHMM_BivalentPoisedTSS.elements.bed
DIGESTIVE_ChromHMM_BivalentPoisedTSS	/data/talkowski/Samples/rCNVmap/data/master_annotations/noncoding/DIGESTIVE_MASTER.ChromHMM_BivalentPoisedTSS.elements.bed
EMBRYO_ChromHMM_BivalentPoisedTSS	/data/talkowski/Samples/rCNVmap/data/master_annotations/noncoding/EMBRYO_MASTER.ChromHMM_BivalentPoisedTSS.elements.bed
ENDOCRINE_ChromHMM_BivalentPoisedTSS	/data/talkowski/Samples/rCNVmap/data/master_annotations/noncoding/ENDOCRINE_MASTER.ChromHMM_BivalentPoisedTSS.elements.bed
FAT_ChromHMM_BivalentPoisedTSS	/data/talkowski/Samples/rCNVmap/data/master_annotations/noncoding/FAT_MASTER.ChromHMM_BivalentPoisedTSS.elements.bed
HEADNECK_ChromHMM_BivalentPoisedTSS	/data/talkowski/Samples/rCNVmap/data/master_annotations/noncoding/HEADNECK_MASTER.ChromHMM_BivalentPoisedTSS.elements.bed
HEART_ChromHMM_BivalentPoisedTSS	/data/talkowski/Samples/rCNVmap/data/master_annotations/noncoding/HEART_MASTER.ChromHMM_BivalentPoisedTSS.elements.bed
IMMUNE_ChromHMM_BivalentPoisedTSS	/data/talkowski/Samples/rCNVmap/data/master_annotations/noncoding/IMMUNE_MASTER.ChromHMM_BivalentPoisedTSS.elements.bed
LUNG_ChromHMM_BivalentPoisedTSS	/data/talkowski/Samples/rCNVmap/data/master_annotations/noncoding/LUNG_MASTER.ChromHMM_BivalentPoisedTSS.elements.bed
MUSCLE_ChromHMM_BivalentPoisedTSS	/data/talkowski/Samples/rCNVmap/data/master_annotations/noncoding/MUSCLE_MASTER.ChromHMM_BivalentPoisedTSS.elements.bed
REPRO_ChromHMM_BivalentPoisedTSS	/data/talkowski/Samples/rCNVmap/data/master_annotations/noncoding/REPRO_MASTER.ChromHMM_BivalentPoisedTSS.elements.bed
SKELETAL_ChromHMM_BivalentPoisedTSS	/data/talkowski/Samples/rCNVmap/data/master_annotations/noncoding/SKELETAL_MASTER.ChromHMM_BivalentPoisedTSS.elements.bed
SKIN_ChromHMM_BivalentPoisedTSS	/data/talkowski/Samples/rCNVmap/data/master_annotations/noncoding/SKIN_MASTER.ChromHMM_BivalentPoisedTSS.elements.bed
BRAIN_ChromHMM_StrongTranscription	/data/talkowski/Samples/rCNVmap/data/master_annotations/noncoding/BRAIN_MASTER.ChromHMM_StrongTranscription.elements.bed
DIGESTIVE_ChromHMM_StrongTranscription	/data/talkowski/Samples/rCNVmap/data/master_annotations/noncoding/DIGESTIVE_MASTER.ChromHMM_StrongTranscription.elements.bed
EMBRYO_ChromHMM_StrongTranscription	/data/talkowski/Samples/rCNVmap/data/master_annotations/noncoding/EMBRYO_MASTER.ChromHMM_StrongTranscription.elements.bed
ENDOCRINE_ChromHMM_StrongTranscription	/data/talkowski/Samples/rCNVmap/data/master_annotations/noncoding/ENDOCRINE_MASTER.ChromHMM_StrongTranscription.elements.bed
FAT_ChromHMM_StrongTranscription	/data/talkowski/Samples/rCNVmap/data/master_annotations/noncoding/FAT_MASTER.ChromHMM_StrongTranscription.elements.bed
HEADNECK_ChromHMM_StrongTranscription	/data/talkowski/Samples/rCNVmap/data/master_annotations/noncoding/HEADNECK_MASTER.ChromHMM_StrongTranscription.elements.bed
HEART_ChromHMM_StrongTranscription	/data/talkowski/Samples/rCNVmap/data/master_annotations/noncoding/HEART_MASTER.ChromHMM_StrongTranscription.elements.bed
IMMUNE_ChromHMM_StrongTranscription	/data/talkowski/Samples/rCNVmap/data/master_annotations/noncoding/IMMUNE_MASTER.ChromHMM_StrongTranscription.elements.bed
LUNG_ChromHMM_StrongTranscription	/data/talkowski/Samples/rCNVmap/data/master_annotations/noncoding/LUNG_MASTER.ChromHMM_StrongTranscription.elements.bed
MUSCLE_ChromHMM_StrongTranscription	/data/talkowski/Samples/rCNVmap/data/master_annotations/noncoding/MUSCLE_MASTER.ChromHMM_StrongTranscription.elements.bed
REPRO_ChromHMM_StrongTranscription	/data/talkowski/Samples/rCNVmap/data/master_annotations/noncoding/REPRO_MASTER.ChromHMM_StrongTranscription.elements.bed
SKELETAL_ChromHMM_StrongTranscription	/data/talkowski/Samples/rCNVmap/data/master_annotations/noncoding/SKELETAL_MASTER.ChromHMM_StrongTranscription.elements.bed
SKIN_ChromHMM_StrongTranscription	/data/talkowski/Samples/rCNVmap/data/master_annotations/noncoding/SKIN_MASTER.ChromHMM_StrongTranscription.elements.bed
BRAIN_ChromHMM_TSSFlankDownstream	/data/talkowski/Samples/rCNVmap/data/master_annotations/noncoding/BRAIN_MASTER.ChromHMM_TSSFlankDownstream.elements.bed
DIGESTIVE_ChromHMM_TSSFlankDownstream	/data/talkowski/Samples/rCNVmap/data/master_annotations/noncoding/DIGESTIVE_MASTER.ChromHMM_TSSFlankDownstream.elements.bed
EMBRYO_ChromHMM_TSSFlankDownstream	/data/talkowski/Samples/rCNVmap/data/master_annotations/noncoding/EMBRYO_MASTER.ChromHMM_TSSFlankDownstream.elements.bed
ENDOCRINE_ChromHMM_TSSFlankDownstream	/data/talkowski/Samples/rCNVmap/data/master_annotations/noncoding/ENDOCRINE_MASTER.ChromHMM_TSSFlankDownstream.elements.bed
FAT_ChromHMM_TSSFlankDownstream	/data/talkowski/Samples/rCNVmap/data/master_annotations/noncoding/FAT_MASTER.ChromHMM_TSSFlankDownstream.elements.bed
HEADNECK_ChromHMM_TSSFlankDownstream	/data/talkowski/Samples/rCNVmap/data/master_annotations/noncoding/HEADNECK_MASTER.ChromHMM_TSSFlankDownstream.elements.bed
HEART_ChromHMM_TSSFlankDownstream	/data/talkowski/Samples/rCNVmap/data/master_annotations/noncoding/HEART_MASTER.ChromHMM_TSSFlankDownstream.elements.bed
IMMUNE_ChromHMM_TSSFlankDownstream	/data/talkowski/Samples/rCNVmap/data/master_annotations/noncoding/IMMUNE_MASTER.ChromHMM_TSSFlankDownstream.elements.bed
LUNG_ChromHMM_TSSFlankDownstream	/data/talkowski/Samples/rCNVmap/data/master_annotations/noncoding/LUNG_MASTER.ChromHMM_TSSFlankDownstream.elements.bed
MUSCLE_ChromHMM_TSSFlankDownstream	/data/talkowski/Samples/rCNVmap/data/master_annotations/noncoding/MUSCLE_MASTER.ChromHMM_TSSFlankDownstream.elements.bed
REPRO_ChromHMM_TSSFlankDownstream	/data/talkowski/Samples/rCNVmap/data/master_annotations/noncoding/REPRO_MASTER.ChromHMM_TSSFlankDownstream.elements.bed
SKELETAL_ChromHMM_TSSFlankDownstream	/data/talkowski/Samples/rCNVmap/data/master_annotations/noncoding/SKELETAL_MASTER.ChromHMM_TSSFlankDownstream.elements.bed
SKIN_ChromHMM_TSSFlankDownstream	/data/talkowski/Samples/rCNVmap/data/master_annotations/noncoding/SKIN_MASTER.ChromHMM_TSSFlankDownstream.elements.bed
BRAIN_ChromHMM_TSSFlankUpstream	/data/talkowski/Samples/rCNVmap/data/master_annotations/noncoding/BRAIN_MASTER.ChromHMM_TSSFlankUpstream.elements.bed
DIGESTIVE_ChromHMM_TSSFlankUpstream	/data/talkowski/Samples/rCNVmap/data/master_annotations/noncoding/DIGESTIVE_MASTER.ChromHMM_TSSFlankUpstream.elements.bed
EMBRYO_ChromHMM_TSSFlankUpstream	/data/talkowski/Samples/rCNVmap/data/master_annotations/noncoding/EMBRYO_MASTER.ChromHMM_TSSFlankUpstream.elements.bed
ENDOCRINE_ChromHMM_TSSFlankUpstream	/data/talkowski/Samples/rCNVmap/data/master_annotations/noncoding/ENDOCRINE_MASTER.ChromHMM_TSSFlankUpstream.elements.bed
FAT_ChromHMM_TSSFlankUpstream	/data/talkowski/Samples/rCNVmap/data/master_annotations/noncoding/FAT_MASTER.ChromHMM_TSSFlankUpstream.elements.bed
HEADNECK_ChromHMM_TSSFlankUpstream	/data/talkowski/Samples/rCNVmap/data/master_annotations/noncoding/HEADNECK_MASTER.ChromHMM_TSSFlankUpstream.elements.bed
HEART_ChromHMM_TSSFlankUpstream	/data/talkowski/Samples/rCNVmap/data/master_annotations/noncoding/HEART_MASTER.ChromHMM_TSSFlankUpstream.elements.bed
IMMUNE_ChromHMM_TSSFlankUpstream	/data/talkowski/Samples/rCNVmap/data/master_annotations/noncoding/IMMUNE_MASTER.ChromHMM_TSSFlankUpstream.elements.bed
LUNG_ChromHMM_TSSFlankUpstream	/data/talkowski/Samples/rCNVmap/data/master_annotations/noncoding/LUNG_MASTER.ChromHMM_TSSFlankUpstream.elements.bed
MUSCLE_ChromHMM_TSSFlankUpstream	/data/talkowski/Samples/rCNVmap/data/master_annotations/noncoding/MUSCLE_MASTER.ChromHMM_TSSFlankUpstream.elements.bed
REPRO_ChromHMM_TSSFlankUpstream	/data/talkowski/Samples/rCNVmap/data/master_annotations/noncoding/REPRO_MASTER.ChromHMM_TSSFlankUpstream.elements.bed
SKELETAL_ChromHMM_TSSFlankUpstream	/data/talkowski/Samples/rCNVmap/data/master_annotations/noncoding/SKELETAL_MASTER.ChromHMM_TSSFlankUpstream.elements.bed
SKIN_ChromHMM_TSSFlankUpstream	/data/talkowski/Samples/rCNVmap/data/master_annotations/noncoding/SKIN_MASTER.ChromHMM_TSSFlankUpstream.elements.bed
BRAIN_ChromHMM_WeakEnhancer	/data/talkowski/Samples/rCNVmap/data/master_annotations/noncoding/BRAIN_MASTER.ChromHMM_WeakEnhancer.elements.bed
DIGESTIVE_ChromHMM_WeakEnhancer	/data/talkowski/Samples/rCNVmap/data/master_annotations/noncoding/DIGESTIVE_MASTER.ChromHMM_WeakEnhancer.elements.bed
EMBRYO_ChromHMM_WeakEnhancer	/data/talkowski/Samples/rCNVmap/data/master_annotations/noncoding/EMBRYO_MASTER.ChromHMM_WeakEnhancer.elements.bed
ENDOCRINE_ChromHMM_WeakEnhancer	/data/talkowski/Samples/rCNVmap/data/master_annotations/noncoding/ENDOCRINE_MASTER.ChromHMM_WeakEnhancer.elements.bed
FAT_ChromHMM_WeakEnhancer	/data/talkowski/Samples/rCNVmap/data/master_annotations/noncoding/FAT_MASTER.ChromHMM_WeakEnhancer.elements.bed
HEADNECK_ChromHMM_WeakEnhancer	/data/talkowski/Samples/rCNVmap/data/master_annotations/noncoding/HEADNECK_MASTER.ChromHMM_WeakEnhancer.elements.bed
HEART_ChromHMM_WeakEnhancer	/data/talkowski/Samples/rCNVmap/data/master_annotations/noncoding/HEART_MASTER.ChromHMM_WeakEnhancer.elements.bed
IMMUNE_ChromHMM_WeakEnhancer	/data/talkowski/Samples/rCNVmap/data/master_annotations/noncoding/IMMUNE_MASTER.ChromHMM_WeakEnhancer.elements.bed
LUNG_ChromHMM_WeakEnhancer	/data/talkowski/Samples/rCNVmap/data/master_annotations/noncoding/LUNG_MASTER.ChromHMM_WeakEnhancer.elements.bed
MUSCLE_ChromHMM_WeakEnhancer	/data/talkowski/Samples/rCNVmap/data/master_annotations/noncoding/MUSCLE_MASTER.ChromHMM_WeakEnhancer.elements.bed
REPRO_ChromHMM_WeakEnhancer	/data/talkowski/Samples/rCNVmap/data/master_annotations/noncoding/REPRO_MASTER.ChromHMM_WeakEnhancer.elements.bed
SKELETAL_ChromHMM_WeakEnhancer	/data/talkowski/Samples/rCNVmap/data/master_annotations/noncoding/SKELETAL_MASTER.ChromHMM_WeakEnhancer.elements.bed
SKIN_ChromHMM_WeakEnhancer	/data/talkowski/Samples/rCNVmap/data/master_annotations/noncoding/SKIN_MASTER.ChromHMM_WeakEnhancer.elements.bed
BRAIN_ChromHMM_WeakRepressedPolycomb	/data/talkowski/Samples/rCNVmap/data/master_annotations/noncoding/BRAIN_MASTER.ChromHMM_WeakRepressedPolycomb.elements.bed
DIGESTIVE_ChromHMM_WeakRepressedPolycomb	/data/talkowski/Samples/rCNVmap/data/master_annotations/noncoding/DIGESTIVE_MASTER.ChromHMM_WeakRepressedPolycomb.elements.bed
EMBRYO_ChromHMM_WeakRepressedPolycomb	/data/talkowski/Samples/rCNVmap/data/master_annotations/noncoding/EMBRYO_MASTER.ChromHMM_WeakRepressedPolycomb.elements.bed
ENDOCRINE_ChromHMM_WeakRepressedPolycomb	/data/talkowski/Samples/rCNVmap/data/master_annotations/noncoding/ENDOCRINE_MASTER.ChromHMM_WeakRepressedPolycomb.elements.bed
FAT_ChromHMM_WeakRepressedPolycomb	/data/talkowski/Samples/rCNVmap/data/master_annotations/noncoding/FAT_MASTER.ChromHMM_WeakRepressedPolycomb.elements.bed
HEADNECK_ChromHMM_WeakRepressedPolycomb	/data/talkowski/Samples/rCNVmap/data/master_annotations/noncoding/HEADNECK_MASTER.ChromHMM_WeakRepressedPolycomb.elements.bed
HEART_ChromHMM_WeakRepressedPolycomb	/data/talkowski/Samples/rCNVmap/data/master_annotations/noncoding/HEART_MASTER.ChromHMM_WeakRepressedPolycomb.elements.bed
IMMUNE_ChromHMM_WeakRepressedPolycomb	/data/talkowski/Samples/rCNVmap/data/master_annotations/noncoding/IMMUNE_MASTER.ChromHMM_WeakRepressedPolycomb.elements.bed
LUNG_ChromHMM_WeakRepressedPolycomb	/data/talkowski/Samples/rCNVmap/data/master_annotations/noncoding/LUNG_MASTER.ChromHMM_WeakRepressedPolycomb.elements.bed
MUSCLE_ChromHMM_WeakRepressedPolycomb	/data/talkowski/Samples/rCNVmap/data/master_annotations/noncoding/MUSCLE_MASTER.ChromHMM_WeakRepressedPolycomb.elements.bed
REPRO_ChromHMM_WeakRepressedPolycomb	/data/talkowski/Samples/rCNVmap/data/master_annotations/noncoding/REPRO_MASTER.ChromHMM_WeakRepressedPolycomb.elements.bed
SKELETAL_ChromHMM_WeakRepressedPolycomb	/data/talkowski/Samples/rCNVmap/data/master_annotations/noncoding/SKELETAL_MASTER.ChromHMM_WeakRepressedPolycomb.elements.bed
SKIN_ChromHMM_WeakRepressedPolycomb	/data/talkowski/Samples/rCNVmap/data/master_annotations/noncoding/SKIN_MASTER.ChromHMM_WeakRepressedPolycomb.elements.bed
BRAIN_ChromHMM_WeakTranscription	/data/talkowski/Samples/rCNVmap/data/master_annotations/noncoding/BRAIN_MASTER.ChromHMM_WeakTranscription.elements.bed
DIGESTIVE_ChromHMM_WeakTranscription	/data/talkowski/Samples/rCNVmap/data/master_annotations/noncoding/DIGESTIVE_MASTER.ChromHMM_WeakTranscription.elements.bed
EMBRYO_ChromHMM_WeakTranscription	/data/talkowski/Samples/rCNVmap/data/master_annotations/noncoding/EMBRYO_MASTER.ChromHMM_WeakTranscription.elements.bed
ENDOCRINE_ChromHMM_WeakTranscription	/data/talkowski/Samples/rCNVmap/data/master_annotations/noncoding/ENDOCRINE_MASTER.ChromHMM_WeakTranscription.elements.bed
FAT_ChromHMM_WeakTranscription	/data/talkowski/Samples/rCNVmap/data/master_annotations/noncoding/FAT_MASTER.ChromHMM_WeakTranscription.elements.bed
HEADNECK_ChromHMM_WeakTranscription	/data/talkowski/Samples/rCNVmap/data/master_annotations/noncoding/HEADNECK_MASTER.ChromHMM_WeakTranscription.elements.bed
HEART_ChromHMM_WeakTranscription	/data/talkowski/Samples/rCNVmap/data/master_annotations/noncoding/HEART_MASTER.ChromHMM_WeakTranscription.elements.bed
IMMUNE_ChromHMM_WeakTranscription	/data/talkowski/Samples/rCNVmap/data/master_annotations/noncoding/IMMUNE_MASTER.ChromHMM_WeakTranscription.elements.bed
LUNG_ChromHMM_WeakTranscription	/data/talkowski/Samples/rCNVmap/data/master_annotations/noncoding/LUNG_MASTER.ChromHMM_WeakTranscription.elements.bed
MUSCLE_ChromHMM_WeakTranscription	/data/talkowski/Samples/rCNVmap/data/master_annotations/noncoding/MUSCLE_MASTER.ChromHMM_WeakTranscription.elements.bed
REPRO_ChromHMM_WeakTranscription	/data/talkowski/Samples/rCNVmap/data/master_annotations/noncoding/REPRO_MASTER.ChromHMM_WeakTranscription.elements.bed
SKELETAL_ChromHMM_WeakTranscription	/data/talkowski/Samples/rCNVmap/data/master_annotations/noncoding/SKELETAL_MASTER.ChromHMM_WeakTranscription.elements.bed
SKIN_ChromHMM_WeakTranscription	/data/talkowski/Samples/rCNVmap/data/master_annotations/noncoding/SKIN_MASTER.ChromHMM_WeakTranscription.elements.bed
BRAIN_ChromHMM_ZNFGenesRepeats	/data/talkowski/Samples/rCNVmap/data/master_annotations/noncoding/BRAIN_MASTER.ChromHMM_ZNFGenesRepeats.elements.bed
DIGESTIVE_ChromHMM_ZNFGenesRepeats	/data/talkowski/Samples/rCNVmap/data/master_annotations/noncoding/DIGESTIVE_MASTER.ChromHMM_ZNFGenesRepeats.elements.bed
EMBRYO_ChromHMM_ZNFGenesRepeats	/data/talkowski/Samples/rCNVmap/data/master_annotations/noncoding/EMBRYO_MASTER.ChromHMM_ZNFGenesRepeats.elements.bed
ENDOCRINE_ChromHMM_ZNFGenesRepeats	/data/talkowski/Samples/rCNVmap/data/master_annotations/noncoding/ENDOCRINE_MASTER.ChromHMM_ZNFGenesRepeats.elements.bed
FAT_ChromHMM_ZNFGenesRepeats	/data/talkowski/Samples/rCNVmap/data/master_annotations/noncoding/FAT_MASTER.ChromHMM_ZNFGenesRepeats.elements.bed
HEADNECK_ChromHMM_ZNFGenesRepeats	/data/talkowski/Samples/rCNVmap/data/master_annotations/noncoding/HEADNECK_MASTER.ChromHMM_ZNFGenesRepeats.elements.bed
HEART_ChromHMM_ZNFGenesRepeats	/data/talkowski/Samples/rCNVmap/data/master_annotations/noncoding/HEART_MASTER.ChromHMM_ZNFGenesRepeats.elements.bed
IMMUNE_ChromHMM_ZNFGenesRepeats	/data/talkowski/Samples/rCNVmap/data/master_annotations/noncoding/IMMUNE_MASTER.ChromHMM_ZNFGenesRepeats.elements.bed
LUNG_ChromHMM_ZNFGenesRepeats	/data/talkowski/Samples/rCNVmap/data/master_annotations/noncoding/LUNG_MASTER.ChromHMM_ZNFGenesRepeats.elements.bed
MUSCLE_ChromHMM_ZNFGenesRepeats	/data/talkowski/Samples/rCNVmap/data/master_annotations/noncoding/MUSCLE_MASTER.ChromHMM_ZNFGenesRepeats.elements.bed
REPRO_ChromHMM_ZNFGenesRepeats	/data/talkowski/Samples/rCNVmap/data/master_annotations/noncoding/REPRO_MASTER.ChromHMM_ZNFGenesRepeats.elements.bed
SKELETAL_ChromHMM_ZNFGenesRepeats	/data/talkowski/Samples/rCNVmap/data/master_annotations/noncoding/SKELETAL_MASTER.ChromHMM_ZNFGenesRepeats.elements.bed
SKIN_ChromHMM_ZNFGenesRepeats	/data/talkowski/Samples/rCNVmap/data/master_annotations/noncoding/SKIN_MASTER.ChromHMM_ZNFGenesRepeats.elements.bed
BRAIN_TAD	/data/talkowski/Samples/rCNVmap/data/master_annotations/noncoding/BRAIN_MASTER.TAD.elements.bed
DIGESTIVE_TAD	/data/talkowski/Samples/rCNVmap/data/master_annotations/noncoding/DIGESTIVE_MASTER.TAD.elements.bed
EMBRYO_TAD	/data/talkowski/Samples/rCNVmap/data/master_annotations/noncoding/EMBRYO_MASTER.TAD.elements.bed
ENDOCRINE_TAD	/data/talkowski/Samples/rCNVmap/data/master_annotations/noncoding/ENDOCRINE_MASTER.TAD.elements.bed
HEART_TAD	/data/talkowski/Samples/rCNVmap/data/master_annotations/noncoding/HEART_MASTER.TAD.elements.bed
IMMUNE_TAD	/data/talkowski/Samples/rCNVmap/data/master_annotations/noncoding/IMMUNE_MASTER.TAD.elements.bed
LUNG_TAD	/data/talkowski/Samples/rCNVmap/data/master_annotations/noncoding/LUNG_MASTER.TAD.elements.bed
MUSCLE_TAD	/data/talkowski/Samples/rCNVmap/data/master_annotations/noncoding/MUSCLE_MASTER.TAD.elements.bed
RENAL_TAD	/data/talkowski/Samples/rCNVmap/data/master_annotations/noncoding/RENAL_MASTER.TAD.elements.bed
REPRO_TAD	/data/talkowski/Samples/rCNVmap/data/master_annotations/noncoding/REPRO_MASTER.TAD.elements.bed
SKIN_TAD	/data/talkowski/Samples/rCNVmap/data/master_annotations/noncoding/SKIN_MASTER.TAD.elements.bed