Conserved_ChromHMM_Active_Enhancers_Class_1	/data/talkowski/Samples/rCNVmap/data/master_annotations/noncoding/ChromHMM_Active_Enhancer_Class1_conserved.elements.bed
Conserved_ChromHMM_Active_Enhancers_Class_2	/data/talkowski/Samples/rCNVmap/data/master_annotations/noncoding/ChromHMM_Active_Enhancer_Class2_conserved.elements.bed
Conserved_ChromHMM_Active_Transcription_Start_Site_Downstream_Flanks	/data/talkowski/Samples/rCNVmap/data/master_annotations/noncoding/ChromHMM_Flanking_TSS_Downstream_conserved.elements.bed
Conserved_ChromHMM_Active_Transcription_Start_Site_Flanks	/data/talkowski/Samples/rCNVmap/data/master_annotations/noncoding/ChromHMM_Flanking_TSS_conserved.elements.bed
Conserved_ChromHMM_Active_Transcription_Start_Site_Upstream_Flanks	/data/talkowski/Samples/rCNVmap/data/master_annotations/noncoding/ChromHMM_Flanking_TSS_Upstream_conserved.elements.bed
Conserved_ChromHMM_Active_Transcription_Start_Sites	/data/talkowski/Samples/rCNVmap/data/master_annotations/noncoding/ChromHMM_Active_TSS_conserved.elements.bed
Conserved_ChromHMM_Bivalent_Enhancers	/data/talkowski/Samples/rCNVmap/data/master_annotations/noncoding/ChromHMM_Bivalent_Enhancer_conserved.elements.bed
Conserved_ChromHMM_BivalentPoised_Transcription_Start_Sites	/data/talkowski/Samples/rCNVmap/data/master_annotations/noncoding/ChromHMM_Bivalent_Poised_TSS_conserved.elements.bed
Conserved_ChromHMM_Genic_Enhancers_Class_1	/data/talkowski/Samples/rCNVmap/data/master_annotations/noncoding/ChromHMM_Genic_Enhancer_Class1_conserved.elements.bed
Conserved_ChromHMM_Genic_Enhancers_Class_2	/data/talkowski/Samples/rCNVmap/data/master_annotations/noncoding/ChromHMM_Genic_Enhancer_Class2_conserved.elements.bed
Conserved_ChromHMM_Heterochromatin	/data/talkowski/Samples/rCNVmap/data/master_annotations/noncoding/ChromHMM_Heterochromatin_conserved.elements.bed
Conserved_ChromHMM_Polycomb_Repressed_Elements	/data/talkowski/Samples/rCNVmap/data/master_annotations/noncoding/ChromHMM_Repressed_PolyComb_conserved.elements.bed
Conserved_ChromHMM_Quiescent_Elements	/data/talkowski/Samples/rCNVmap/data/master_annotations/noncoding/ChromHMM_Quiescent_Low_conserved.elements.bed
Conserved_ChromHMM_Strong_Transcribed_Elements	/data/talkowski/Samples/rCNVmap/data/master_annotations/noncoding/ChromHMM_Strong_Transcription_conserved.elements.bed
Conserved_ChromHMM_Weak_Enhancers	/data/talkowski/Samples/rCNVmap/data/master_annotations/noncoding/ChromHMM_Weak_Enhancer_conserved.elements.bed
Conserved_ChromHMM_Weak_Polycomb_Repressed_Elements	/data/talkowski/Samples/rCNVmap/data/master_annotations/noncoding/ChromHMM_Weak_Repressed_PolyComb_conserved.elements.bed
Conserved_ChromHMM_Weak_Transcribed_Elements	/data/talkowski/Samples/rCNVmap/data/master_annotations/noncoding/ChromHMM_Weak_Transcription_conserved.elements.bed
Conserved_ChromHMM_ZNF_Genes_&_Repeats	/data/talkowski/Samples/rCNVmap/data/master_annotations/noncoding/ChromHMM_ZNF_Genes_Repeats_conserved.elements.bed
Conserved_DHS	/data/talkowski/Samples/rCNVmap/data/master_annotations/noncoding/DHS_conserved.elements.bed
Conserved_Enhancers	/data/talkowski/Samples/rCNVmap/data/master_annotations/noncoding/enhancers_conserved.elements.bed
Conserved_eQTLs	/data/talkowski/Samples/rCNVmap/data/master_annotations/noncoding/eQTLs_conserved.elements.bed
Conserved_FIREs	/data/talkowski/Samples/rCNVmap/data/master_annotations/noncoding/FIREs_conserved.elements.bed
Conserved_H3K27ac	/data/talkowski/Samples/rCNVmap/data/master_annotations/noncoding/H3K27ac_conserved.elements.bed
Conserved_partially_methylated_domains	/data/talkowski/Samples/rCNVmap/data/master_annotations/noncoding/PMDs_conserved.elements.bed
Conserved_Strong_Active_A_Compartments	/data/talkowski/Samples/rCNVmap/data/master_annotations/noncoding/strongCompartmentsA_conserved.elements.bed
Conserved_Strong_Repressive_B_Compartments	/data/talkowski/Samples/rCNVmap/data/master_annotations/noncoding/strongCompartmentsB_conserved.elements.bed
Conserved_Super_Enhancers	/data/talkowski/Samples/rCNVmap/data/master_annotations/noncoding/superEnhancers_conserved.elements.bed
Conserved_TBRs	/data/talkowski/Samples/rCNVmap/data/master_annotations/noncoding/TBRs_conserved.elements.bed
Highly_conserved_ChromHMM_Active_Enhancers_Class_1	/data/talkowski/Samples/rCNVmap/data/master_annotations/noncoding/ChromHMM_Active_Enhancer_Class1_highlyConserved.elements.bed
Highly_conserved_ChromHMM_Active_Enhancers_Class_2	/data/talkowski/Samples/rCNVmap/data/master_annotations/noncoding/ChromHMM_Active_Enhancer_Class2_highlyConserved.elements.bed
Highly_conserved_ChromHMM_Active_Transcription_Start_Site_Downstream_Flanks	/data/talkowski/Samples/rCNVmap/data/master_annotations/noncoding/ChromHMM_Flanking_TSS_Downstream_highlyConserved.elements.bed
Highly_conserved_ChromHMM_Active_Transcription_Start_Site_Flanks	/data/talkowski/Samples/rCNVmap/data/master_annotations/noncoding/ChromHMM_Flanking_TSS_highlyConserved.elements.bed
Highly_conserved_ChromHMM_Active_Transcription_Start_Site_Upstream_Flanks	/data/talkowski/Samples/rCNVmap/data/master_annotations/noncoding/ChromHMM_Flanking_TSS_Upstream_highlyConserved.elements.bed
Highly_conserved_ChromHMM_Active_Transcription_Start_Sites	/data/talkowski/Samples/rCNVmap/data/master_annotations/noncoding/ChromHMM_Active_TSS_highlyConserved.elements.bed
Highly_conserved_ChromHMM_Bivalent_Enhancers	/data/talkowski/Samples/rCNVmap/data/master_annotations/noncoding/ChromHMM_Bivalent_Enhancer_highlyConserved.elements.bed
Highly_conserved_ChromHMM_BivalentPoised_Transcription_Start_Sites	/data/talkowski/Samples/rCNVmap/data/master_annotations/noncoding/ChromHMM_Bivalent_Poised_TSS_highlyConserved.elements.bed
Highly_conserved_ChromHMM_Genic_Enhancers_Class_1	/data/talkowski/Samples/rCNVmap/data/master_annotations/noncoding/ChromHMM_Genic_Enhancer_Class1_highlyConserved.elements.bed
Highly_conserved_ChromHMM_Genic_Enhancers_Class_2	/data/talkowski/Samples/rCNVmap/data/master_annotations/noncoding/ChromHMM_Genic_Enhancer_Class2_highlyConserved.elements.bed
Highly_conserved_ChromHMM_Heterochromatin	/data/talkowski/Samples/rCNVmap/data/master_annotations/noncoding/ChromHMM_Heterochromatin_highlyConserved.elements.bed
Highly_conserved_ChromHMM_Polycomb_Repressed_Elements	/data/talkowski/Samples/rCNVmap/data/master_annotations/noncoding/ChromHMM_Repressed_PolyComb_highlyConserved.elements.bed
Highly_conserved_ChromHMM_Quiescent_Elements	/data/talkowski/Samples/rCNVmap/data/master_annotations/noncoding/ChromHMM_Quiescent_Low_highlyConserved.elements.bed
Highly_conserved_ChromHMM_Strong_Transcribed_Elements	/data/talkowski/Samples/rCNVmap/data/master_annotations/noncoding/ChromHMM_Strong_Transcription_highlyConserved.elements.bed
Highly_conserved_ChromHMM_Weak_Enhancers	/data/talkowski/Samples/rCNVmap/data/master_annotations/noncoding/ChromHMM_Weak_Enhancer_highlyConserved.elements.bed
Highly_conserved_ChromHMM_Weak_Polycomb_Repressed_Elements	/data/talkowski/Samples/rCNVmap/data/master_annotations/noncoding/ChromHMM_Weak_Repressed_PolyComb_highlyConserved.elements.bed
Highly_conserved_ChromHMM_Weak_Transcribed_Elements	/data/talkowski/Samples/rCNVmap/data/master_annotations/noncoding/ChromHMM_Weak_Transcription_highlyConserved.elements.bed
Highly_conserved_ChromHMM_ZNF_Genes_&_Repeats	/data/talkowski/Samples/rCNVmap/data/master_annotations/noncoding/ChromHMM_ZNF_Genes_Repeats_highlyConserved.elements.bed
Highly_conserved_DHS	/data/talkowski/Samples/rCNVmap/data/master_annotations/noncoding/DHS_highlyConserved.elements.bed
Highly_Conserved_Enhancers	/data/talkowski/Samples/rCNVmap/data/master_annotations/noncoding/enhancers_highlyConserved.elements.bed
Highly_conserved_eQTLs	/data/talkowski/Samples/rCNVmap/data/master_annotations/noncoding/eQTLs_highlyConserved.elements.bed
Highly_conserved_FIREs	/data/talkowski/Samples/rCNVmap/data/master_annotations/noncoding/FIREs_highlyConserved.elements.bed
Highly_conserved_H3K27ac	/data/talkowski/Samples/rCNVmap/data/master_annotations/noncoding/H3K27ac_highlyConserved.elements.bed
Highly_conserved_partially_methylated_domains	/data/talkowski/Samples/rCNVmap/data/master_annotations/noncoding/PMDs_highlyConserved.elements.bed
Highly_Conserved_Strong_Active_A_Compartments	/data/talkowski/Samples/rCNVmap/data/master_annotations/noncoding/strongCompartmentsA_highlyConserved.elements.bed
Highly_Conserved_Strong_Repressive_B_Compartments	/data/talkowski/Samples/rCNVmap/data/master_annotations/noncoding/strongCompartmentsB_highlyConserved.elements.bed
Highly_Conserved_Super_Enhancers	/data/talkowski/Samples/rCNVmap/data/master_annotations/noncoding/superEnhancers_highlyConserved.elements.bed
Highly_conserved_TBRs	/data/talkowski/Samples/rCNVmap/data/master_annotations/noncoding/TBRs_highlyConserved.elements.bed
Strong_TFBS_All_TFs	/data/talkowski/Samples/rCNVmap/data/master_annotations/noncoding/StrongTFBS_union.elements.bed
Strong_TFBS_ATF3	/data/talkowski/Samples/rCNVmap/data/master_annotations/noncoding/StrongTFBS_ATF3.elements.bed
Strong_TFBS_BCL3	/data/talkowski/Samples/rCNVmap/data/master_annotations/noncoding/StrongTFBS_BCL3.elements.bed
Strong_TFBS_BHLHE40	/data/talkowski/Samples/rCNVmap/data/master_annotations/noncoding/StrongTFBS_BHLHE40.elements.bed
Strong_TFBS_BRCA1	/data/talkowski/Samples/rCNVmap/data/master_annotations/noncoding/StrongTFBS_BRCA1.elements.bed
Strong_TFBS_CEBPB	/data/talkowski/Samples/rCNVmap/data/master_annotations/noncoding/StrongTFBS_CEBPB.elements.bed
Strong_TFBS_CHD1	/data/talkowski/Samples/rCNVmap/data/master_annotations/noncoding/StrongTFBS_CHD1.elements.bed
Strong_TFBS_CHD2	/data/talkowski/Samples/rCNVmap/data/master_annotations/noncoding/StrongTFBS_CHD2.elements.bed
Strong_TFBS_CTCF	/data/talkowski/Samples/rCNVmap/data/master_annotations/noncoding/StrongTFBS_CTCF.elements.bed
Strong_TFBS_E2F1	/data/talkowski/Samples/rCNVmap/data/master_annotations/noncoding/StrongTFBS_E2F1.elements.bed
Strong_TFBS_E2F4	/data/talkowski/Samples/rCNVmap/data/master_annotations/noncoding/StrongTFBS_E2F4.elements.bed
Strong_TFBS_E2F6	/data/talkowski/Samples/rCNVmap/data/master_annotations/noncoding/StrongTFBS_E2F6.elements.bed
Strong_TFBS_EGR1	/data/talkowski/Samples/rCNVmap/data/master_annotations/noncoding/StrongTFBS_EGR1.elements.bed
Strong_TFBS_ELF1	/data/talkowski/Samples/rCNVmap/data/master_annotations/noncoding/StrongTFBS_ELF1.elements.bed
Strong_TFBS_ELK1	/data/talkowski/Samples/rCNVmap/data/master_annotations/noncoding/StrongTFBS_ELK1.elements.bed
Strong_TFBS_EP300	/data/talkowski/Samples/rCNVmap/data/master_annotations/noncoding/StrongTFBS_EP300.elements.bed
Strong_TFBS_ESR1	/data/talkowski/Samples/rCNVmap/data/master_annotations/noncoding/StrongTFBS_ESR1.elements.bed
Strong_TFBS_ETS1	/data/talkowski/Samples/rCNVmap/data/master_annotations/noncoding/StrongTFBS_ETS1.elements.bed
Strong_TFBS_EZH2	/data/talkowski/Samples/rCNVmap/data/master_annotations/noncoding/StrongTFBS_EZH2.elements.bed
Strong_TFBS_FOS	/data/talkowski/Samples/rCNVmap/data/master_annotations/noncoding/StrongTFBS_FOS.elements.bed
Strong_TFBS_FOXA1	/data/talkowski/Samples/rCNVmap/data/master_annotations/noncoding/StrongTFBS_FOXA1.elements.bed
Strong_TFBS_GABPA	/data/talkowski/Samples/rCNVmap/data/master_annotations/noncoding/StrongTFBS_GABPA.elements.bed
Strong_TFBS_GATA1	/data/talkowski/Samples/rCNVmap/data/master_annotations/noncoding/StrongTFBS_GATA1.elements.bed
Strong_TFBS_GATA2	/data/talkowski/Samples/rCNVmap/data/master_annotations/noncoding/StrongTFBS_GATA2.elements.bed
Strong_TFBS_GATA3	/data/talkowski/Samples/rCNVmap/data/master_annotations/noncoding/StrongTFBS_GATA3.elements.bed
Strong_TFBS_GTF2F1	/data/talkowski/Samples/rCNVmap/data/master_annotations/noncoding/StrongTFBS_GTF2F1.elements.bed
Strong_TFBS_HDAC2	/data/talkowski/Samples/rCNVmap/data/master_annotations/noncoding/StrongTFBS_HDAC2.elements.bed
Strong_TFBS_IRF1	/data/talkowski/Samples/rCNVmap/data/master_annotations/noncoding/StrongTFBS_IRF1.elements.bed
Strong_TFBS_JUN	/data/talkowski/Samples/rCNVmap/data/master_annotations/noncoding/StrongTFBS_JUN.elements.bed
Strong_TFBS_JUND	/data/talkowski/Samples/rCNVmap/data/master_annotations/noncoding/StrongTFBS_JUND.elements.bed
Strong_TFBS_KAP1	/data/talkowski/Samples/rCNVmap/data/master_annotations/noncoding/StrongTFBS_KAP1.elements.bed
Strong_TFBS_MAFK	/data/talkowski/Samples/rCNVmap/data/master_annotations/noncoding/StrongTFBS_MAFK.elements.bed
Strong_TFBS_MAX	/data/talkowski/Samples/rCNVmap/data/master_annotations/noncoding/StrongTFBS_MAX.elements.bed
Strong_TFBS_MAZ	/data/talkowski/Samples/rCNVmap/data/master_annotations/noncoding/StrongTFBS_MAZ.elements.bed
Strong_TFBS_MXI1	/data/talkowski/Samples/rCNVmap/data/master_annotations/noncoding/StrongTFBS_MXI1.elements.bed
Strong_TFBS_MYC	/data/talkowski/Samples/rCNVmap/data/master_annotations/noncoding/StrongTFBS_MYC.elements.bed
Strong_TFBS_NFYA	/data/talkowski/Samples/rCNVmap/data/master_annotations/noncoding/StrongTFBS_NFYA.elements.bed
Strong_TFBS_NFYB	/data/talkowski/Samples/rCNVmap/data/master_annotations/noncoding/StrongTFBS_NFYB.elements.bed
Strong_TFBS_NR2C2	/data/talkowski/Samples/rCNVmap/data/master_annotations/noncoding/StrongTFBS_NR2C2.elements.bed
Strong_TFBS_NR3C1	/data/talkowski/Samples/rCNVmap/data/master_annotations/noncoding/StrongTFBS_NR3C1.elements.bed
Strong_TFBS_NRF1	/data/talkowski/Samples/rCNVmap/data/master_annotations/noncoding/StrongTFBS_NRF1.elements.bed
Strong_TFBS_PAX5	/data/talkowski/Samples/rCNVmap/data/master_annotations/noncoding/StrongTFBS_PAX5.elements.bed
Strong_TFBS_POLR2A	/data/talkowski/Samples/rCNVmap/data/master_annotations/noncoding/StrongTFBS_POLR2A.elements.bed
Strong_TFBS_RAD21	/data/talkowski/Samples/rCNVmap/data/master_annotations/noncoding/StrongTFBS_RAD21.elements.bed
Strong_TFBS_RCOR1	/data/talkowski/Samples/rCNVmap/data/master_annotations/noncoding/StrongTFBS_RCOR1.elements.bed
Strong_TFBS_RELA	/data/talkowski/Samples/rCNVmap/data/master_annotations/noncoding/StrongTFBS_RELA.elements.bed
Strong_TFBS_REST	/data/talkowski/Samples/rCNVmap/data/master_annotations/noncoding/StrongTFBS_REST.elements.bed
Strong_TFBS_RFX5	/data/talkowski/Samples/rCNVmap/data/master_annotations/noncoding/StrongTFBS_RFX5.elements.bed
Strong_TFBS_RXRA	/data/talkowski/Samples/rCNVmap/data/master_annotations/noncoding/StrongTFBS_RXRA.elements.bed
Strong_TFBS_SETDB1	/data/talkowski/Samples/rCNVmap/data/master_annotations/noncoding/StrongTFBS_SETDB1.elements.bed
Strong_TFBS_SIN3AK20	/data/talkowski/Samples/rCNVmap/data/master_annotations/noncoding/StrongTFBS_SIN3AK20.elements.bed
Strong_TFBS_SIX5	/data/talkowski/Samples/rCNVmap/data/master_annotations/noncoding/StrongTFBS_SIX5.elements.bed
Strong_TFBS_SMC3	/data/talkowski/Samples/rCNVmap/data/master_annotations/noncoding/StrongTFBS_SMC3.elements.bed
Strong_TFBS_SP1	/data/talkowski/Samples/rCNVmap/data/master_annotations/noncoding/StrongTFBS_SP1.elements.bed
Strong_TFBS_SP2	/data/talkowski/Samples/rCNVmap/data/master_annotations/noncoding/StrongTFBS_SP2.elements.bed
Strong_TFBS_SPI1	/data/talkowski/Samples/rCNVmap/data/master_annotations/noncoding/StrongTFBS_SPI1.elements.bed
Strong_TFBS_SRF	/data/talkowski/Samples/rCNVmap/data/master_annotations/noncoding/StrongTFBS_SRF.elements.bed
Strong_TFBS_STAT1	/data/talkowski/Samples/rCNVmap/data/master_annotations/noncoding/StrongTFBS_STAT1.elements.bed
Strong_TFBS_STAT3	/data/talkowski/Samples/rCNVmap/data/master_annotations/noncoding/StrongTFBS_STAT3.elements.bed
Strong_TFBS_TAF1	/data/talkowski/Samples/rCNVmap/data/master_annotations/noncoding/StrongTFBS_TAF1.elements.bed
Strong_TFBS_TBL1XR1	/data/talkowski/Samples/rCNVmap/data/master_annotations/noncoding/StrongTFBS_TBL1XR1.elements.bed
Strong_TFBS_TBP	/data/talkowski/Samples/rCNVmap/data/master_annotations/noncoding/StrongTFBS_TBP.elements.bed
Strong_TFBS_TCF12	/data/talkowski/Samples/rCNVmap/data/master_annotations/noncoding/StrongTFBS_TCF12.elements.bed
Strong_TFBS_TCF7L2	/data/talkowski/Samples/rCNVmap/data/master_annotations/noncoding/StrongTFBS_TCF7L2.elements.bed
Strong_TFBS_TEAD4	/data/talkowski/Samples/rCNVmap/data/master_annotations/noncoding/StrongTFBS_TEAD4.elements.bed
Strong_TFBS_USF1	/data/talkowski/Samples/rCNVmap/data/master_annotations/noncoding/StrongTFBS_USF1.elements.bed
Strong_TFBS_USF2	/data/talkowski/Samples/rCNVmap/data/master_annotations/noncoding/StrongTFBS_USF2.elements.bed
Strong_TFBS_YY1	/data/talkowski/Samples/rCNVmap/data/master_annotations/noncoding/StrongTFBS_YY1.elements.bed
Strong_TFBS_ZBTB33	/data/talkowski/Samples/rCNVmap/data/master_annotations/noncoding/StrongTFBS_ZBTB33.elements.bed
Strong_TFBS_ZNF143	/data/talkowski/Samples/rCNVmap/data/master_annotations/noncoding/StrongTFBS_ZNF143.elements.bed
Strong_TFBS_ZNF274	/data/talkowski/Samples/rCNVmap/data/master_annotations/noncoding/StrongTFBS_ZNF274.elements.bed
Evolutionarily_conserved_elements_Consensus	/data/talkowski/Samples/rCNVmap/data/master_annotations/noncoding/evolutionarilyConserved_consensus.elements.bed
Evolutionarily_conserved_elements_GERP	/data/talkowski/Samples/rCNVmap/data/master_annotations/noncoding/evolutionarilyConserved_GERP.elements.bed
Evolutionarily_conserved_elements_PhyloP	/data/talkowski/Samples/rCNVmap/data/master_annotations/noncoding/evolutionarilyConserved_PhyloP.elements.bed
Human_accellerated_regions_HARs_[Conservative_Set]	/data/talkowski/Samples/rCNVmap/data/master_annotations/noncoding/HARs_conservative.elements.bed
Ultraconserved_elements_UCEs	/data/talkowski/Samples/rCNVmap/data/master_annotations/noncoding/UCEs_McCole.elements.bed
Ultraconserved_noncoding_elements_UCNEs	/data/talkowski/Samples/rCNVmap/data/master_annotations/noncoding/UCNEs.elements.bed
TFBS_All_TFs	/data/talkowski/Samples/rCNVmap/data/master_annotations/noncoding/TFBS_union.elements.bed
TFBS_ATF3	/data/talkowski/Samples/rCNVmap/data/master_annotations/noncoding/TFBS_ATF3.elements.bed
TFBS_BCL3	/data/talkowski/Samples/rCNVmap/data/master_annotations/noncoding/TFBS_BCL3.elements.bed
TFBS_BHLHE40	/data/talkowski/Samples/rCNVmap/data/master_annotations/noncoding/TFBS_BHLHE40.elements.bed
TFBS_BRCA1	/data/talkowski/Samples/rCNVmap/data/master_annotations/noncoding/TFBS_BRCA1.elements.bed
TFBS_CEBPB	/data/talkowski/Samples/rCNVmap/data/master_annotations/noncoding/TFBS_CEBPB.elements.bed
TFBS_CHD1	/data/talkowski/Samples/rCNVmap/data/master_annotations/noncoding/TFBS_CHD1.elements.bed
TFBS_CHD2	/data/talkowski/Samples/rCNVmap/data/master_annotations/noncoding/TFBS_CHD2.elements.bed
TFBS_CTCF	/data/talkowski/Samples/rCNVmap/data/master_annotations/noncoding/TFBS_CTCF.elements.bed
TFBS_E2F1	/data/talkowski/Samples/rCNVmap/data/master_annotations/noncoding/TFBS_E2F1.elements.bed
TFBS_E2F4	/data/talkowski/Samples/rCNVmap/data/master_annotations/noncoding/TFBS_E2F4.elements.bed
TFBS_E2F6	/data/talkowski/Samples/rCNVmap/data/master_annotations/noncoding/TFBS_E2F6.elements.bed
TFBS_EGR1	/data/talkowski/Samples/rCNVmap/data/master_annotations/noncoding/TFBS_EGR1.elements.bed
TFBS_ELF1	/data/talkowski/Samples/rCNVmap/data/master_annotations/noncoding/TFBS_ELF1.elements.bed
TFBS_ELK1	/data/talkowski/Samples/rCNVmap/data/master_annotations/noncoding/TFBS_ELK1.elements.bed
TFBS_EP300	/data/talkowski/Samples/rCNVmap/data/master_annotations/noncoding/TFBS_EP300.elements.bed
TFBS_ESR1	/data/talkowski/Samples/rCNVmap/data/master_annotations/noncoding/TFBS_ESR1.elements.bed
TFBS_ETS1	/data/talkowski/Samples/rCNVmap/data/master_annotations/noncoding/TFBS_ETS1.elements.bed
TFBS_EZH2	/data/talkowski/Samples/rCNVmap/data/master_annotations/noncoding/TFBS_EZH2.elements.bed
TFBS_FOS	/data/talkowski/Samples/rCNVmap/data/master_annotations/noncoding/TFBS_FOS.elements.bed
TFBS_FOXA1	/data/talkowski/Samples/rCNVmap/data/master_annotations/noncoding/TFBS_FOXA1.elements.bed
TFBS_GABPA	/data/talkowski/Samples/rCNVmap/data/master_annotations/noncoding/TFBS_GABPA.elements.bed
TFBS_GATA1	/data/talkowski/Samples/rCNVmap/data/master_annotations/noncoding/TFBS_GATA1.elements.bed
TFBS_GATA2	/data/talkowski/Samples/rCNVmap/data/master_annotations/noncoding/TFBS_GATA2.elements.bed
TFBS_GATA3	/data/talkowski/Samples/rCNVmap/data/master_annotations/noncoding/TFBS_GATA3.elements.bed
TFBS_GTF2F1	/data/talkowski/Samples/rCNVmap/data/master_annotations/noncoding/TFBS_GTF2F1.elements.bed
TFBS_HDAC2	/data/talkowski/Samples/rCNVmap/data/master_annotations/noncoding/TFBS_HDAC2.elements.bed
TFBS_IRF1	/data/talkowski/Samples/rCNVmap/data/master_annotations/noncoding/TFBS_IRF1.elements.bed
TFBS_JUN	/data/talkowski/Samples/rCNVmap/data/master_annotations/noncoding/TFBS_JUN.elements.bed
TFBS_JUND	/data/talkowski/Samples/rCNVmap/data/master_annotations/noncoding/TFBS_JUND.elements.bed
TFBS_KAP1	/data/talkowski/Samples/rCNVmap/data/master_annotations/noncoding/TFBS_KAP1.elements.bed
TFBS_MAFK	/data/talkowski/Samples/rCNVmap/data/master_annotations/noncoding/TFBS_MAFK.elements.bed
TFBS_MAX	/data/talkowski/Samples/rCNVmap/data/master_annotations/noncoding/TFBS_MAX.elements.bed
TFBS_MAZ	/data/talkowski/Samples/rCNVmap/data/master_annotations/noncoding/TFBS_MAZ.elements.bed
TFBS_MXI1	/data/talkowski/Samples/rCNVmap/data/master_annotations/noncoding/TFBS_MXI1.elements.bed
TFBS_MYC	/data/talkowski/Samples/rCNVmap/data/master_annotations/noncoding/TFBS_MYC.elements.bed
TFBS_NFYA	/data/talkowski/Samples/rCNVmap/data/master_annotations/noncoding/TFBS_NFYA.elements.bed
TFBS_NFYB	/data/talkowski/Samples/rCNVmap/data/master_annotations/noncoding/TFBS_NFYB.elements.bed
TFBS_NR2C2	/data/talkowski/Samples/rCNVmap/data/master_annotations/noncoding/TFBS_NR2C2.elements.bed
TFBS_NR3C1	/data/talkowski/Samples/rCNVmap/data/master_annotations/noncoding/TFBS_NR3C1.elements.bed
TFBS_NRF1	/data/talkowski/Samples/rCNVmap/data/master_annotations/noncoding/TFBS_NRF1.elements.bed
TFBS_PAX5	/data/talkowski/Samples/rCNVmap/data/master_annotations/noncoding/TFBS_PAX5.elements.bed
TFBS_POLR2A	/data/talkowski/Samples/rCNVmap/data/master_annotations/noncoding/TFBS_POLR2A.elements.bed
TFBS_RAD21	/data/talkowski/Samples/rCNVmap/data/master_annotations/noncoding/TFBS_RAD21.elements.bed
TFBS_RCOR1	/data/talkowski/Samples/rCNVmap/data/master_annotations/noncoding/TFBS_RCOR1.elements.bed
TFBS_RELA	/data/talkowski/Samples/rCNVmap/data/master_annotations/noncoding/TFBS_RELA.elements.bed
TFBS_REST	/data/talkowski/Samples/rCNVmap/data/master_annotations/noncoding/TFBS_REST.elements.bed
TFBS_RFX5	/data/talkowski/Samples/rCNVmap/data/master_annotations/noncoding/TFBS_RFX5.elements.bed
TFBS_RXRA	/data/talkowski/Samples/rCNVmap/data/master_annotations/noncoding/TFBS_RXRA.elements.bed
TFBS_SETDB1	/data/talkowski/Samples/rCNVmap/data/master_annotations/noncoding/TFBS_SETDB1.elements.bed
TFBS_SIN3AK20	/data/talkowski/Samples/rCNVmap/data/master_annotations/noncoding/TFBS_SIN3AK20.elements.bed
TFBS_SIX5	/data/talkowski/Samples/rCNVmap/data/master_annotations/noncoding/TFBS_SIX5.elements.bed
TFBS_SMC3	/data/talkowski/Samples/rCNVmap/data/master_annotations/noncoding/TFBS_SMC3.elements.bed
TFBS_SP1	/data/talkowski/Samples/rCNVmap/data/master_annotations/noncoding/TFBS_SP1.elements.bed
TFBS_SP2	/data/talkowski/Samples/rCNVmap/data/master_annotations/noncoding/TFBS_SP2.elements.bed
TFBS_SPI1	/data/talkowski/Samples/rCNVmap/data/master_annotations/noncoding/TFBS_SPI1.elements.bed
TFBS_SRF	/data/talkowski/Samples/rCNVmap/data/master_annotations/noncoding/TFBS_SRF.elements.bed
TFBS_STAT1	/data/talkowski/Samples/rCNVmap/data/master_annotations/noncoding/TFBS_STAT1.elements.bed
TFBS_STAT3	/data/talkowski/Samples/rCNVmap/data/master_annotations/noncoding/TFBS_STAT3.elements.bed
TFBS_TAF1	/data/talkowski/Samples/rCNVmap/data/master_annotations/noncoding/TFBS_TAF1.elements.bed
TFBS_TBL1XR1	/data/talkowski/Samples/rCNVmap/data/master_annotations/noncoding/TFBS_TBL1XR1.elements.bed
TFBS_TBP	/data/talkowski/Samples/rCNVmap/data/master_annotations/noncoding/TFBS_TBP.elements.bed
TFBS_TCF12	/data/talkowski/Samples/rCNVmap/data/master_annotations/noncoding/TFBS_TCF12.elements.bed
TFBS_TCF7L2	/data/talkowski/Samples/rCNVmap/data/master_annotations/noncoding/TFBS_TCF7L2.elements.bed
TFBS_TEAD4	/data/talkowski/Samples/rCNVmap/data/master_annotations/noncoding/TFBS_TEAD4.elements.bed
TFBS_USF1	/data/talkowski/Samples/rCNVmap/data/master_annotations/noncoding/TFBS_USF1.elements.bed
TFBS_USF2	/data/talkowski/Samples/rCNVmap/data/master_annotations/noncoding/TFBS_USF2.elements.bed
TFBS_YY1	/data/talkowski/Samples/rCNVmap/data/master_annotations/noncoding/TFBS_YY1.elements.bed
TFBS_ZBTB33	/data/talkowski/Samples/rCNVmap/data/master_annotations/noncoding/TFBS_ZBTB33.elements.bed
TFBS_ZNF143	/data/talkowski/Samples/rCNVmap/data/master_annotations/noncoding/TFBS_ZNF143.elements.bed
TFBS_ZNF274	/data/talkowski/Samples/rCNVmap/data/master_annotations/noncoding/TFBS_ZNF274.elements.bed
Rolling_circle_repeats	/data/talkowski/Samples/rCNVmap/data/master_annotations/noncoding/RepeatMasker_RC.elements.bed
Satellites	/data/talkowski/Samples/rCNVmap/data/master_annotations/noncoding/RepeatMasker_Satellite.elements.bed
Segmental_Duplications	/data/talkowski/Samples/rCNVmap/data/master_annotations/noncoding/SegDups.elements.bed
Simple_repeats	/data/talkowski/Samples/rCNVmap/data/master_annotations/noncoding/RepeatMasker_Simple_repeat.elements.bed
SINEs	/data/talkowski/Samples/rCNVmap/data/master_annotations/noncoding/RepeatMasker_SINE.elements.bed
LINEs	/data/talkowski/Samples/rCNVmap/data/master_annotations/noncoding/RepeatMasker_LINE.elements.bed
Low_complexity_repeats	/data/talkowski/Samples/rCNVmap/data/master_annotations/noncoding/RepeatMasker_Low_complexity.elements.bed
LTRs	/data/talkowski/Samples/rCNVmap/data/master_annotations/noncoding/RepeatMasker_LTR.elements.bed
DNA_repeats	/data/talkowski/Samples/rCNVmap/data/master_annotations/noncoding/RepeatMasker_DNA.elements.bed
CpG_Islands	/data/talkowski/Samples/rCNVmap/data/master_annotations/noncoding/CpG_islands.elements.bed
Recombination_hotspots	/data/talkowski/Samples/rCNVmap/data/master_annotations/noncoding/Recombination_Hotspots.elements.bed
Late_replicating_regions	/data/talkowski/Samples/rCNVmap/data/master_annotations/noncoding/lateReplicating_Koren.elements.bed
Early_replicating_regions	/data/talkowski/Samples/rCNVmap/data/master_annotations/noncoding/earlyReplicating_Koren.elements.bed
Autosomal_syndromic_CNV_loci	/data/talkowski/Samples/rCNVmap/data/master_annotations/noncoding/syndromic_CNVs.elements.bed
GWAS_Loci_Autism_spectrum_disorder	/data/talkowski/Samples/rCNVmap/data/master_annotations/noncoding/GWAS_loci_ASD.elements.bed
GWAS_Loci_Behavioral_abnormality_other	/data/talkowski/Samples/rCNVmap/data/master_annotations/noncoding/GWAS_loci_BEHAV.elements.bed
GWAS_Loci_Blood_cancer	/data/talkowski/Samples/rCNVmap/data/master_annotations/noncoding/GWAS_loci_CBLD.elements.bed
GWAS_Loci_Brain_cancer	/data/talkowski/Samples/rCNVmap/data/master_annotations/noncoding/GWAS_loci_CBRN.elements.bed
GWAS_Loci_Breast_cancer	/data/talkowski/Samples/rCNVmap/data/master_annotations/noncoding/GWAS_loci_CBST.elements.bed
GWAS_Loci_Cancer	/data/talkowski/Samples/rCNVmap/data/master_annotations/noncoding/GWAS_loci_CNCR.elements.bed
GWAS_Loci_Cardiac_defect	/data/talkowski/Samples/rCNVmap/data/master_annotations/noncoding/GWAS_loci_CARD.elements.bed
GWAS_Loci_Developmental_delay	/data/talkowski/Samples/rCNVmap/data/master_annotations/noncoding/GWAS_loci_DD.elements.bed
GWAS_Loci_Digestive_respiratory_or_urinary_defect	/data/talkowski/Samples/rCNVmap/data/master_annotations/noncoding/GWAS_loci_DRU.elements.bed
GWAS_Loci_Endocrine_cancer	/data/talkowski/Samples/rCNVmap/data/master_annotations/noncoding/GWAS_loci_CEND.elements.bed
GWAS_Loci_Endocrine_metabolic_or_immune_defect	/data/talkowski/Samples/rCNVmap/data/master_annotations/noncoding/GWAS_loci_EMI.elements.bed
GWAS_Loci_Eye_or_ear_defect	/data/talkowski/Samples/rCNVmap/data/master_annotations/noncoding/GWAS_loci_EE.elements.bed
GWAS_Loci_Gastrointestinal_cancer	/data/talkowski/Samples/rCNVmap/data/master_annotations/noncoding/GWAS_loci_CGST.elements.bed
GWAS_Loci_Genital_cancer	/data/talkowski/Samples/rCNVmap/data/master_annotations/noncoding/GWAS_loci_CGEN.elements.bed
GWAS_Loci_Germline_disease	/data/talkowski/Samples/rCNVmap/data/master_annotations/noncoding/GWAS_loci_GERM.elements.bed
GWAS_Loci_Growth_defect	/data/talkowski/Samples/rCNVmap/data/master_annotations/noncoding/GWAS_loci_GRO.elements.bed
GWAS_Loci_Head_or_neck_cancer	/data/talkowski/Samples/rCNVmap/data/master_annotations/noncoding/GWAS_loci_CHNK.elements.bed
GWAS_Loci_Head_or_neck_defect	/data/talkowski/Samples/rCNVmap/data/master_annotations/noncoding/GWAS_loci_HEAD.elements.bed
GWAS_Loci_Integument_defect	/data/talkowski/Samples/rCNVmap/data/master_annotations/noncoding/GWAS_loci_INT.elements.bed
GWAS_Loci_Intellectual_disability	/data/talkowski/Samples/rCNVmap/data/master_annotations/noncoding/GWAS_loci_ID.elements.bed
GWAS_Loci_Liver_cancer	/data/talkowski/Samples/rCNVmap/data/master_annotations/noncoding/GWAS_loci_CLIV.elements.bed
GWAS_Loci_Lung_cancer	/data/talkowski/Samples/rCNVmap/data/master_annotations/noncoding/GWAS_loci_CLNG.elements.bed
GWAS_Loci_Muscular_defect	/data/talkowski/Samples/rCNVmap/data/master_annotations/noncoding/GWAS_loci_MSC.elements.bed
GWAS_Loci_Musculoskeletal_cancer	/data/talkowski/Samples/rCNVmap/data/master_annotations/noncoding/GWAS_loci_CMSK.elements.bed
GWAS_Loci_Neurodevelopmental_disorder	/data/talkowski/Samples/rCNVmap/data/master_annotations/noncoding/GWAS_loci_NDD.elements.bed
GWAS_Loci_Neurological_defect	/data/talkowski/Samples/rCNVmap/data/master_annotations/noncoding/GWAS_loci_NEURO.elements.bed
GWAS_Loci_Neuropsychiatric_disorder	/data/talkowski/Samples/rCNVmap/data/master_annotations/noncoding/GWAS_loci_PSYCH.elements.bed
GWAS_Loci_Nonneurological_defect	/data/talkowski/Samples/rCNVmap/data/master_annotations/noncoding/GWAS_loci_SOMA.elements.bed
GWAS_Loci_Renal_cancer	/data/talkowski/Samples/rCNVmap/data/master_annotations/noncoding/GWAS_loci_CRNL.elements.bed
GWAS_Loci_Schizophrenia	/data/talkowski/Samples/rCNVmap/data/master_annotations/noncoding/GWAS_loci_SCZ.elements.bed
GWAS_Loci_Seizures	/data/talkowski/Samples/rCNVmap/data/master_annotations/noncoding/GWAS_loci_SEIZ.elements.bed
GWAS_Loci_Skeletal_defect	/data/talkowski/Samples/rCNVmap/data/master_annotations/noncoding/GWAS_loci_SKEL.elements.bed
GWAS_Loci_Skin_cancer	/data/talkowski/Samples/rCNVmap/data/master_annotations/noncoding/GWAS_loci_CSKN.elements.bed
GWAS_Loci_Various_quantitative_physiological_&_biochemical_measurements	/data/talkowski/Samples/rCNVmap/data/master_annotations/noncoding/GWAS_loci_CTRL.elements.bed
TBRs_All_Cell_Lines	/data/talkowski/Samples/rCNVmap/data/master_annotations/noncoding/TBRs_AllCellLines.elements.bed
TBRs_All_Primary_Tissues	/data/talkowski/Samples/rCNVmap/data/master_annotations/noncoding/TBRs_AllPrimaryTissues.elements.bed
TBRs_All_Sources	/data/talkowski/Samples/rCNVmap/data/master_annotations/noncoding/TBRs_AllSources.elements.bed
FIREs_All_Cell_Lines	/data/talkowski/Samples/rCNVmap/data/master_annotations/noncoding/FIREs_AllCellLines.elements.bed
FIREs_All_Primary_Tissues	/data/talkowski/Samples/rCNVmap/data/master_annotations/noncoding/FIREs_AllPrimaryTissues.elements.bed
FIREs_All_Sources	/data/talkowski/Samples/rCNVmap/data/master_annotations/noncoding/FIREs_AllSources.elements.bed
BRAIN_ChromHMM_ActiveEnhancer1	/data/talkowski/Samples/rCNVmap/data/master_annotations/noncoding/BRAIN_MASTER.ChromHMM_ActiveEnhancer1.elements.bed
BRAIN_ChromHMM_ActiveEnhancer2	/data/talkowski/Samples/rCNVmap/data/master_annotations/noncoding/BRAIN_MASTER.ChromHMM_ActiveEnhancer2.elements.bed
BRAIN_ChromHMM_ActiveTSS	/data/talkowski/Samples/rCNVmap/data/master_annotations/noncoding/BRAIN_MASTER.ChromHMM_ActiveTSS.elements.bed
BRAIN_ChromHMM_ActiveTSSFlanks	/data/talkowski/Samples/rCNVmap/data/master_annotations/noncoding/BRAIN_MASTER.ChromHMM_ActiveTSSFlanks.elements.bed
BRAIN_ChromHMM_BivalentEnhancer	/data/talkowski/Samples/rCNVmap/data/master_annotations/noncoding/BRAIN_MASTER.ChromHMM_BivalentEnhancer.elements.bed
BRAIN_ChromHMM_BivalentPoisedTSS	/data/talkowski/Samples/rCNVmap/data/master_annotations/noncoding/BRAIN_MASTER.ChromHMM_BivalentPoisedTSS.elements.bed
BRAIN_ChromHMM_GenicEnhancer1	/data/talkowski/Samples/rCNVmap/data/master_annotations/noncoding/BRAIN_MASTER.ChromHMM_GenicEnhancer1.elements.bed
BRAIN_ChromHMM_GenicEnhancer2	/data/talkowski/Samples/rCNVmap/data/master_annotations/noncoding/BRAIN_MASTER.ChromHMM_GenicEnhancer2.elements.bed
BRAIN_ChromHMM_Heterochromatin	/data/talkowski/Samples/rCNVmap/data/master_annotations/noncoding/BRAIN_MASTER.ChromHMM_Heterochromatin.elements.bed
BRAIN_ChromHMM_Quiescent	/data/talkowski/Samples/rCNVmap/data/master_annotations/noncoding/BRAIN_MASTER.ChromHMM_Quiescent.elements.bed
BRAIN_ChromHMM_RepressedPolycomb	/data/talkowski/Samples/rCNVmap/data/master_annotations/noncoding/BRAIN_MASTER.ChromHMM_RepressedPolycomb.elements.bed
BRAIN_ChromHMM_StrongTranscription	/data/talkowski/Samples/rCNVmap/data/master_annotations/noncoding/BRAIN_MASTER.ChromHMM_StrongTranscription.elements.bed
BRAIN_ChromHMM_TSSFlankDownstream	/data/talkowski/Samples/rCNVmap/data/master_annotations/noncoding/BRAIN_MASTER.ChromHMM_TSSFlankDownstream.elements.bed
BRAIN_ChromHMM_TSSFlankUpstream	/data/talkowski/Samples/rCNVmap/data/master_annotations/noncoding/BRAIN_MASTER.ChromHMM_TSSFlankUpstream.elements.bed
BRAIN_ChromHMM_WeakEnhancer	/data/talkowski/Samples/rCNVmap/data/master_annotations/noncoding/BRAIN_MASTER.ChromHMM_WeakEnhancer.elements.bed
BRAIN_ChromHMM_WeakRepressedPolycomb	/data/talkowski/Samples/rCNVmap/data/master_annotations/noncoding/BRAIN_MASTER.ChromHMM_WeakRepressedPolycomb.elements.bed
BRAIN_ChromHMM_WeakTranscription	/data/talkowski/Samples/rCNVmap/data/master_annotations/noncoding/BRAIN_MASTER.ChromHMM_WeakTranscription.elements.bed
BRAIN_ChromHMM_ZNFGenesRepeats	/data/talkowski/Samples/rCNVmap/data/master_annotations/noncoding/BRAIN_MASTER.ChromHMM_ZNFGenesRepeats.elements.bed
BRAIN_CompartmentA	/data/talkowski/Samples/rCNVmap/data/master_annotations/noncoding/BRAIN_MASTER.CompartmentA.elements.bed
BRAIN_CompartmentB	/data/talkowski/Samples/rCNVmap/data/master_annotations/noncoding/BRAIN_MASTER.CompartmentB.elements.bed
BRAIN_DHS	/data/talkowski/Samples/rCNVmap/data/master_annotations/noncoding/BRAIN_MASTER.DHS.elements.bed
BRAIN_DMRs	/data/talkowski/Samples/rCNVmap/data/master_annotations/noncoding/BRAIN_MASTER.DMRs.elements.bed
BRAIN_Enhancer	/data/talkowski/Samples/rCNVmap/data/master_annotations/noncoding/BRAIN_MASTER.Enhancer.elements.bed
BRAIN_eQTLs	/data/talkowski/Samples/rCNVmap/data/master_annotations/noncoding/BRAIN_MASTER.eQTLs.elements.bed
BRAIN_FIRE	/data/talkowski/Samples/rCNVmap/data/master_annotations/noncoding/BRAIN_MASTER.FIRE.elements.bed
BRAIN_H3K27ac	/data/talkowski/Samples/rCNVmap/data/master_annotations/noncoding/BRAIN_MASTER.H3K27ac.elements.bed
BRAIN_StrongDHS	/data/talkowski/Samples/rCNVmap/data/master_annotations/noncoding/BRAIN_MASTER.StrongDHS.elements.bed
BRAIN_StrongH3K27ac	/data/talkowski/Samples/rCNVmap/data/master_annotations/noncoding/BRAIN_MASTER.StrongH3K27ac.elements.bed
BRAIN_SuperEnhancer	/data/talkowski/Samples/rCNVmap/data/master_annotations/noncoding/BRAIN_MASTER.SuperEnhancer.elements.bed
BRAIN_TAD	/data/talkowski/Samples/rCNVmap/data/master_annotations/noncoding/BRAIN_MASTER.TAD.elements.bed
BRAIN_TBR	/data/talkowski/Samples/rCNVmap/data/master_annotations/noncoding/BRAIN_MASTER.TBR.elements.bed
DIGESTIVE_ChromHMM_ActiveEnhancer1	/data/talkowski/Samples/rCNVmap/data/master_annotations/noncoding/DIGESTIVE_MASTER.ChromHMM_ActiveEnhancer1.elements.bed
DIGESTIVE_ChromHMM_ActiveEnhancer2	/data/talkowski/Samples/rCNVmap/data/master_annotations/noncoding/DIGESTIVE_MASTER.ChromHMM_ActiveEnhancer2.elements.bed
DIGESTIVE_ChromHMM_ActiveTSS	/data/talkowski/Samples/rCNVmap/data/master_annotations/noncoding/DIGESTIVE_MASTER.ChromHMM_ActiveTSS.elements.bed
DIGESTIVE_ChromHMM_ActiveTSSFlanks	/data/talkowski/Samples/rCNVmap/data/master_annotations/noncoding/DIGESTIVE_MASTER.ChromHMM_ActiveTSSFlanks.elements.bed
DIGESTIVE_ChromHMM_BivalentEnhancer	/data/talkowski/Samples/rCNVmap/data/master_annotations/noncoding/DIGESTIVE_MASTER.ChromHMM_BivalentEnhancer.elements.bed
DIGESTIVE_ChromHMM_BivalentPoisedTSS	/data/talkowski/Samples/rCNVmap/data/master_annotations/noncoding/DIGESTIVE_MASTER.ChromHMM_BivalentPoisedTSS.elements.bed
DIGESTIVE_ChromHMM_GenicEnhancer1	/data/talkowski/Samples/rCNVmap/data/master_annotations/noncoding/DIGESTIVE_MASTER.ChromHMM_GenicEnhancer1.elements.bed
DIGESTIVE_ChromHMM_GenicEnhancer2	/data/talkowski/Samples/rCNVmap/data/master_annotations/noncoding/DIGESTIVE_MASTER.ChromHMM_GenicEnhancer2.elements.bed
DIGESTIVE_ChromHMM_Heterochromatin	/data/talkowski/Samples/rCNVmap/data/master_annotations/noncoding/DIGESTIVE_MASTER.ChromHMM_Heterochromatin.elements.bed
DIGESTIVE_ChromHMM_Quiescent	/data/talkowski/Samples/rCNVmap/data/master_annotations/noncoding/DIGESTIVE_MASTER.ChromHMM_Quiescent.elements.bed
DIGESTIVE_ChromHMM_RepressedPolycomb	/data/talkowski/Samples/rCNVmap/data/master_annotations/noncoding/DIGESTIVE_MASTER.ChromHMM_RepressedPolycomb.elements.bed
DIGESTIVE_ChromHMM_StrongTranscription	/data/talkowski/Samples/rCNVmap/data/master_annotations/noncoding/DIGESTIVE_MASTER.ChromHMM_StrongTranscription.elements.bed
DIGESTIVE_ChromHMM_TSSFlankDownstream	/data/talkowski/Samples/rCNVmap/data/master_annotations/noncoding/DIGESTIVE_MASTER.ChromHMM_TSSFlankDownstream.elements.bed
DIGESTIVE_ChromHMM_TSSFlankUpstream	/data/talkowski/Samples/rCNVmap/data/master_annotations/noncoding/DIGESTIVE_MASTER.ChromHMM_TSSFlankUpstream.elements.bed
DIGESTIVE_ChromHMM_WeakEnhancer	/data/talkowski/Samples/rCNVmap/data/master_annotations/noncoding/DIGESTIVE_MASTER.ChromHMM_WeakEnhancer.elements.bed
DIGESTIVE_ChromHMM_WeakRepressedPolycomb	/data/talkowski/Samples/rCNVmap/data/master_annotations/noncoding/DIGESTIVE_MASTER.ChromHMM_WeakRepressedPolycomb.elements.bed
DIGESTIVE_ChromHMM_WeakTranscription	/data/talkowski/Samples/rCNVmap/data/master_annotations/noncoding/DIGESTIVE_MASTER.ChromHMM_WeakTranscription.elements.bed
DIGESTIVE_ChromHMM_ZNFGenesRepeats	/data/talkowski/Samples/rCNVmap/data/master_annotations/noncoding/DIGESTIVE_MASTER.ChromHMM_ZNFGenesRepeats.elements.bed
DIGESTIVE_CompartmentA	/data/talkowski/Samples/rCNVmap/data/master_annotations/noncoding/DIGESTIVE_MASTER.CompartmentA.elements.bed
DIGESTIVE_CompartmentB	/data/talkowski/Samples/rCNVmap/data/master_annotations/noncoding/DIGESTIVE_MASTER.CompartmentB.elements.bed
DIGESTIVE_DHS	/data/talkowski/Samples/rCNVmap/data/master_annotations/noncoding/DIGESTIVE_MASTER.DHS.elements.bed
DIGESTIVE_DMRs	/data/talkowski/Samples/rCNVmap/data/master_annotations/noncoding/DIGESTIVE_MASTER.DMRs.elements.bed
DIGESTIVE_Enhancer	/data/talkowski/Samples/rCNVmap/data/master_annotations/noncoding/DIGESTIVE_MASTER.Enhancer.elements.bed
DIGESTIVE_eQTLs	/data/talkowski/Samples/rCNVmap/data/master_annotations/noncoding/DIGESTIVE_MASTER.eQTLs.elements.bed
DIGESTIVE_FIRE	/data/talkowski/Samples/rCNVmap/data/master_annotations/noncoding/DIGESTIVE_MASTER.FIRE.elements.bed
DIGESTIVE_H3K27ac	/data/talkowski/Samples/rCNVmap/data/master_annotations/noncoding/DIGESTIVE_MASTER.H3K27ac.elements.bed
DIGESTIVE_PMDs	/data/talkowski/Samples/rCNVmap/data/master_annotations/noncoding/DIGESTIVE_MASTER.PMDs.elements.bed
DIGESTIVE_StrongDHS	/data/talkowski/Samples/rCNVmap/data/master_annotations/noncoding/DIGESTIVE_MASTER.StrongDHS.elements.bed
DIGESTIVE_StrongH3K27ac	/data/talkowski/Samples/rCNVmap/data/master_annotations/noncoding/DIGESTIVE_MASTER.StrongH3K27ac.elements.bed
DIGESTIVE_SuperEnhancer	/data/talkowski/Samples/rCNVmap/data/master_annotations/noncoding/DIGESTIVE_MASTER.SuperEnhancer.elements.bed
DIGESTIVE_TAD	/data/talkowski/Samples/rCNVmap/data/master_annotations/noncoding/DIGESTIVE_MASTER.TAD.elements.bed
DIGESTIVE_TBR	/data/talkowski/Samples/rCNVmap/data/master_annotations/noncoding/DIGESTIVE_MASTER.TBR.elements.bed
EMBRYO_ChromHMM_ActiveEnhancer1	/data/talkowski/Samples/rCNVmap/data/master_annotations/noncoding/EMBRYO_MASTER.ChromHMM_ActiveEnhancer1.elements.bed
EMBRYO_ChromHMM_ActiveEnhancer2	/data/talkowski/Samples/rCNVmap/data/master_annotations/noncoding/EMBRYO_MASTER.ChromHMM_ActiveEnhancer2.elements.bed
EMBRYO_ChromHMM_ActiveTSS	/data/talkowski/Samples/rCNVmap/data/master_annotations/noncoding/EMBRYO_MASTER.ChromHMM_ActiveTSS.elements.bed
EMBRYO_ChromHMM_ActiveTSSFlanks	/data/talkowski/Samples/rCNVmap/data/master_annotations/noncoding/EMBRYO_MASTER.ChromHMM_ActiveTSSFlanks.elements.bed
EMBRYO_ChromHMM_BivalentEnhancer	/data/talkowski/Samples/rCNVmap/data/master_annotations/noncoding/EMBRYO_MASTER.ChromHMM_BivalentEnhancer.elements.bed
EMBRYO_ChromHMM_BivalentPoisedTSS	/data/talkowski/Samples/rCNVmap/data/master_annotations/noncoding/EMBRYO_MASTER.ChromHMM_BivalentPoisedTSS.elements.bed
EMBRYO_ChromHMM_GenicEnhancer1	/data/talkowski/Samples/rCNVmap/data/master_annotations/noncoding/EMBRYO_MASTER.ChromHMM_GenicEnhancer1.elements.bed
EMBRYO_ChromHMM_GenicEnhancer2	/data/talkowski/Samples/rCNVmap/data/master_annotations/noncoding/EMBRYO_MASTER.ChromHMM_GenicEnhancer2.elements.bed
EMBRYO_ChromHMM_Heterochromatin	/data/talkowski/Samples/rCNVmap/data/master_annotations/noncoding/EMBRYO_MASTER.ChromHMM_Heterochromatin.elements.bed
EMBRYO_ChromHMM_Quiescent	/data/talkowski/Samples/rCNVmap/data/master_annotations/noncoding/EMBRYO_MASTER.ChromHMM_Quiescent.elements.bed
EMBRYO_ChromHMM_RepressedPolycomb	/data/talkowski/Samples/rCNVmap/data/master_annotations/noncoding/EMBRYO_MASTER.ChromHMM_RepressedPolycomb.elements.bed
EMBRYO_ChromHMM_StrongTranscription	/data/talkowski/Samples/rCNVmap/data/master_annotations/noncoding/EMBRYO_MASTER.ChromHMM_StrongTranscription.elements.bed
EMBRYO_ChromHMM_TSSFlankDownstream	/data/talkowski/Samples/rCNVmap/data/master_annotations/noncoding/EMBRYO_MASTER.ChromHMM_TSSFlankDownstream.elements.bed
EMBRYO_ChromHMM_TSSFlankUpstream	/data/talkowski/Samples/rCNVmap/data/master_annotations/noncoding/EMBRYO_MASTER.ChromHMM_TSSFlankUpstream.elements.bed
EMBRYO_ChromHMM_WeakEnhancer	/data/talkowski/Samples/rCNVmap/data/master_annotations/noncoding/EMBRYO_MASTER.ChromHMM_WeakEnhancer.elements.bed
EMBRYO_ChromHMM_WeakRepressedPolycomb	/data/talkowski/Samples/rCNVmap/data/master_annotations/noncoding/EMBRYO_MASTER.ChromHMM_WeakRepressedPolycomb.elements.bed
EMBRYO_ChromHMM_WeakTranscription	/data/talkowski/Samples/rCNVmap/data/master_annotations/noncoding/EMBRYO_MASTER.ChromHMM_WeakTranscription.elements.bed
EMBRYO_ChromHMM_ZNFGenesRepeats	/data/talkowski/Samples/rCNVmap/data/master_annotations/noncoding/EMBRYO_MASTER.ChromHMM_ZNFGenesRepeats.elements.bed
EMBRYO_CompartmentA	/data/talkowski/Samples/rCNVmap/data/master_annotations/noncoding/EMBRYO_MASTER.CompartmentA.elements.bed
EMBRYO_CompartmentB	/data/talkowski/Samples/rCNVmap/data/master_annotations/noncoding/EMBRYO_MASTER.CompartmentB.elements.bed
EMBRYO_DHS	/data/talkowski/Samples/rCNVmap/data/master_annotations/noncoding/EMBRYO_MASTER.DHS.elements.bed
EMBRYO_DMRs	/data/talkowski/Samples/rCNVmap/data/master_annotations/noncoding/EMBRYO_MASTER.DMRs.elements.bed
EMBRYO_Enhancer	/data/talkowski/Samples/rCNVmap/data/master_annotations/noncoding/EMBRYO_MASTER.Enhancer.elements.bed
EMBRYO_FIRE	/data/talkowski/Samples/rCNVmap/data/master_annotations/noncoding/EMBRYO_MASTER.FIRE.elements.bed
EMBRYO_H3K27ac	/data/talkowski/Samples/rCNVmap/data/master_annotations/noncoding/EMBRYO_MASTER.H3K27ac.elements.bed
EMBRYO_StrongDHS	/data/talkowski/Samples/rCNVmap/data/master_annotations/noncoding/EMBRYO_MASTER.StrongDHS.elements.bed
EMBRYO_StrongH3K27ac	/data/talkowski/Samples/rCNVmap/data/master_annotations/noncoding/EMBRYO_MASTER.StrongH3K27ac.elements.bed
EMBRYO_TAD	/data/talkowski/Samples/rCNVmap/data/master_annotations/noncoding/EMBRYO_MASTER.TAD.elements.bed
EMBRYO_TBR	/data/talkowski/Samples/rCNVmap/data/master_annotations/noncoding/EMBRYO_MASTER.TBR.elements.bed
ENDOCRINE_ChromHMM_ActiveEnhancer1	/data/talkowski/Samples/rCNVmap/data/master_annotations/noncoding/ENDOCRINE_MASTER.ChromHMM_ActiveEnhancer1.elements.bed
ENDOCRINE_ChromHMM_ActiveEnhancer2	/data/talkowski/Samples/rCNVmap/data/master_annotations/noncoding/ENDOCRINE_MASTER.ChromHMM_ActiveEnhancer2.elements.bed
ENDOCRINE_ChromHMM_ActiveTSS	/data/talkowski/Samples/rCNVmap/data/master_annotations/noncoding/ENDOCRINE_MASTER.ChromHMM_ActiveTSS.elements.bed
ENDOCRINE_ChromHMM_ActiveTSSFlanks	/data/talkowski/Samples/rCNVmap/data/master_annotations/noncoding/ENDOCRINE_MASTER.ChromHMM_ActiveTSSFlanks.elements.bed
ENDOCRINE_ChromHMM_BivalentEnhancer	/data/talkowski/Samples/rCNVmap/data/master_annotations/noncoding/ENDOCRINE_MASTER.ChromHMM_BivalentEnhancer.elements.bed
ENDOCRINE_ChromHMM_BivalentPoisedTSS	/data/talkowski/Samples/rCNVmap/data/master_annotations/noncoding/ENDOCRINE_MASTER.ChromHMM_BivalentPoisedTSS.elements.bed
ENDOCRINE_ChromHMM_GenicEnhancer1	/data/talkowski/Samples/rCNVmap/data/master_annotations/noncoding/ENDOCRINE_MASTER.ChromHMM_GenicEnhancer1.elements.bed
ENDOCRINE_ChromHMM_GenicEnhancer2	/data/talkowski/Samples/rCNVmap/data/master_annotations/noncoding/ENDOCRINE_MASTER.ChromHMM_GenicEnhancer2.elements.bed
ENDOCRINE_ChromHMM_Heterochromatin	/data/talkowski/Samples/rCNVmap/data/master_annotations/noncoding/ENDOCRINE_MASTER.ChromHMM_Heterochromatin.elements.bed
ENDOCRINE_ChromHMM_Quiescent	/data/talkowski/Samples/rCNVmap/data/master_annotations/noncoding/ENDOCRINE_MASTER.ChromHMM_Quiescent.elements.bed
ENDOCRINE_ChromHMM_RepressedPolycomb	/data/talkowski/Samples/rCNVmap/data/master_annotations/noncoding/ENDOCRINE_MASTER.ChromHMM_RepressedPolycomb.elements.bed
ENDOCRINE_ChromHMM_StrongTranscription	/data/talkowski/Samples/rCNVmap/data/master_annotations/noncoding/ENDOCRINE_MASTER.ChromHMM_StrongTranscription.elements.bed
ENDOCRINE_ChromHMM_TSSFlankDownstream	/data/talkowski/Samples/rCNVmap/data/master_annotations/noncoding/ENDOCRINE_MASTER.ChromHMM_TSSFlankDownstream.elements.bed
ENDOCRINE_ChromHMM_TSSFlankUpstream	/data/talkowski/Samples/rCNVmap/data/master_annotations/noncoding/ENDOCRINE_MASTER.ChromHMM_TSSFlankUpstream.elements.bed
ENDOCRINE_ChromHMM_WeakEnhancer	/data/talkowski/Samples/rCNVmap/data/master_annotations/noncoding/ENDOCRINE_MASTER.ChromHMM_WeakEnhancer.elements.bed
ENDOCRINE_ChromHMM_WeakRepressedPolycomb	/data/talkowski/Samples/rCNVmap/data/master_annotations/noncoding/ENDOCRINE_MASTER.ChromHMM_WeakRepressedPolycomb.elements.bed
ENDOCRINE_ChromHMM_WeakTranscription	/data/talkowski/Samples/rCNVmap/data/master_annotations/noncoding/ENDOCRINE_MASTER.ChromHMM_WeakTranscription.elements.bed
ENDOCRINE_ChromHMM_ZNFGenesRepeats	/data/talkowski/Samples/rCNVmap/data/master_annotations/noncoding/ENDOCRINE_MASTER.ChromHMM_ZNFGenesRepeats.elements.bed
ENDOCRINE_CompartmentA	/data/talkowski/Samples/rCNVmap/data/master_annotations/noncoding/ENDOCRINE_MASTER.CompartmentA.elements.bed
ENDOCRINE_CompartmentB	/data/talkowski/Samples/rCNVmap/data/master_annotations/noncoding/ENDOCRINE_MASTER.CompartmentB.elements.bed
ENDOCRINE_DHS	/data/talkowski/Samples/rCNVmap/data/master_annotations/noncoding/ENDOCRINE_MASTER.DHS.elements.bed
ENDOCRINE_DMRs	/data/talkowski/Samples/rCNVmap/data/master_annotations/noncoding/ENDOCRINE_MASTER.DMRs.elements.bed
ENDOCRINE_eQTLs	/data/talkowski/Samples/rCNVmap/data/master_annotations/noncoding/ENDOCRINE_MASTER.eQTLs.elements.bed
ENDOCRINE_FIRE	/data/talkowski/Samples/rCNVmap/data/master_annotations/noncoding/ENDOCRINE_MASTER.FIRE.elements.bed
ENDOCRINE_H3K27ac	/data/talkowski/Samples/rCNVmap/data/master_annotations/noncoding/ENDOCRINE_MASTER.H3K27ac.elements.bed
ENDOCRINE_PMDs	/data/talkowski/Samples/rCNVmap/data/master_annotations/noncoding/ENDOCRINE_MASTER.PMDs.elements.bed
ENDOCRINE_StrongDHS	/data/talkowski/Samples/rCNVmap/data/master_annotations/noncoding/ENDOCRINE_MASTER.StrongDHS.elements.bed
ENDOCRINE_StrongH3K27ac	/data/talkowski/Samples/rCNVmap/data/master_annotations/noncoding/ENDOCRINE_MASTER.StrongH3K27ac.elements.bed
ENDOCRINE_SuperEnhancer	/data/talkowski/Samples/rCNVmap/data/master_annotations/noncoding/ENDOCRINE_MASTER.SuperEnhancer.elements.bed
ENDOCRINE_TAD	/data/talkowski/Samples/rCNVmap/data/master_annotations/noncoding/ENDOCRINE_MASTER.TAD.elements.bed
ENDOCRINE_TBR	/data/talkowski/Samples/rCNVmap/data/master_annotations/noncoding/ENDOCRINE_MASTER.TBR.elements.bed
FAT_ChromHMM_ActiveEnhancer1	/data/talkowski/Samples/rCNVmap/data/master_annotations/noncoding/FAT_MASTER.ChromHMM_ActiveEnhancer1.elements.bed
FAT_ChromHMM_ActiveEnhancer2	/data/talkowski/Samples/rCNVmap/data/master_annotations/noncoding/FAT_MASTER.ChromHMM_ActiveEnhancer2.elements.bed
FAT_ChromHMM_ActiveTSS	/data/talkowski/Samples/rCNVmap/data/master_annotations/noncoding/FAT_MASTER.ChromHMM_ActiveTSS.elements.bed
FAT_ChromHMM_ActiveTSSFlanks	/data/talkowski/Samples/rCNVmap/data/master_annotations/noncoding/FAT_MASTER.ChromHMM_ActiveTSSFlanks.elements.bed
FAT_ChromHMM_BivalentEnhancer	/data/talkowski/Samples/rCNVmap/data/master_annotations/noncoding/FAT_MASTER.ChromHMM_BivalentEnhancer.elements.bed
FAT_ChromHMM_BivalentPoisedTSS	/data/talkowski/Samples/rCNVmap/data/master_annotations/noncoding/FAT_MASTER.ChromHMM_BivalentPoisedTSS.elements.bed
FAT_ChromHMM_GenicEnhancer1	/data/talkowski/Samples/rCNVmap/data/master_annotations/noncoding/FAT_MASTER.ChromHMM_GenicEnhancer1.elements.bed
FAT_ChromHMM_GenicEnhancer2	/data/talkowski/Samples/rCNVmap/data/master_annotations/noncoding/FAT_MASTER.ChromHMM_GenicEnhancer2.elements.bed
FAT_ChromHMM_Heterochromatin	/data/talkowski/Samples/rCNVmap/data/master_annotations/noncoding/FAT_MASTER.ChromHMM_Heterochromatin.elements.bed
FAT_ChromHMM_Quiescent	/data/talkowski/Samples/rCNVmap/data/master_annotations/noncoding/FAT_MASTER.ChromHMM_Quiescent.elements.bed
FAT_ChromHMM_RepressedPolycomb	/data/talkowski/Samples/rCNVmap/data/master_annotations/noncoding/FAT_MASTER.ChromHMM_RepressedPolycomb.elements.bed
FAT_ChromHMM_StrongTranscription	/data/talkowski/Samples/rCNVmap/data/master_annotations/noncoding/FAT_MASTER.ChromHMM_StrongTranscription.elements.bed
FAT_ChromHMM_TSSFlankDownstream	/data/talkowski/Samples/rCNVmap/data/master_annotations/noncoding/FAT_MASTER.ChromHMM_TSSFlankDownstream.elements.bed
FAT_ChromHMM_TSSFlankUpstream	/data/talkowski/Samples/rCNVmap/data/master_annotations/noncoding/FAT_MASTER.ChromHMM_TSSFlankUpstream.elements.bed
FAT_ChromHMM_WeakEnhancer	/data/talkowski/Samples/rCNVmap/data/master_annotations/noncoding/FAT_MASTER.ChromHMM_WeakEnhancer.elements.bed
FAT_ChromHMM_WeakRepressedPolycomb	/data/talkowski/Samples/rCNVmap/data/master_annotations/noncoding/FAT_MASTER.ChromHMM_WeakRepressedPolycomb.elements.bed
FAT_ChromHMM_WeakTranscription	/data/talkowski/Samples/rCNVmap/data/master_annotations/noncoding/FAT_MASTER.ChromHMM_WeakTranscription.elements.bed
FAT_ChromHMM_ZNFGenesRepeats	/data/talkowski/Samples/rCNVmap/data/master_annotations/noncoding/FAT_MASTER.ChromHMM_ZNFGenesRepeats.elements.bed
FAT_DMRs	/data/talkowski/Samples/rCNVmap/data/master_annotations/noncoding/FAT_MASTER.DMRs.elements.bed
FAT_eQTLs	/data/talkowski/Samples/rCNVmap/data/master_annotations/noncoding/FAT_MASTER.eQTLs.elements.bed
FAT_H3K27ac	/data/talkowski/Samples/rCNVmap/data/master_annotations/noncoding/FAT_MASTER.H3K27ac.elements.bed
FAT_PMDs	/data/talkowski/Samples/rCNVmap/data/master_annotations/noncoding/FAT_MASTER.PMDs.elements.bed
FAT_StrongH3K27ac	/data/talkowski/Samples/rCNVmap/data/master_annotations/noncoding/FAT_MASTER.StrongH3K27ac.elements.bed
FAT_SuperEnhancer	/data/talkowski/Samples/rCNVmap/data/master_annotations/noncoding/FAT_MASTER.SuperEnhancer.elements.bed
HEADNECK_ChromHMM_ActiveEnhancer1	/data/talkowski/Samples/rCNVmap/data/master_annotations/noncoding/HEADNECK_MASTER.ChromHMM_ActiveEnhancer1.elements.bed
HEADNECK_ChromHMM_ActiveEnhancer2	/data/talkowski/Samples/rCNVmap/data/master_annotations/noncoding/HEADNECK_MASTER.ChromHMM_ActiveEnhancer2.elements.bed
HEADNECK_ChromHMM_ActiveTSS	/data/talkowski/Samples/rCNVmap/data/master_annotations/noncoding/HEADNECK_MASTER.ChromHMM_ActiveTSS.elements.bed
HEADNECK_ChromHMM_ActiveTSSFlanks	/data/talkowski/Samples/rCNVmap/data/master_annotations/noncoding/HEADNECK_MASTER.ChromHMM_ActiveTSSFlanks.elements.bed
HEADNECK_ChromHMM_BivalentEnhancer	/data/talkowski/Samples/rCNVmap/data/master_annotations/noncoding/HEADNECK_MASTER.ChromHMM_BivalentEnhancer.elements.bed
HEADNECK_ChromHMM_BivalentPoisedTSS	/data/talkowski/Samples/rCNVmap/data/master_annotations/noncoding/HEADNECK_MASTER.ChromHMM_BivalentPoisedTSS.elements.bed
HEADNECK_ChromHMM_GenicEnhancer1	/data/talkowski/Samples/rCNVmap/data/master_annotations/noncoding/HEADNECK_MASTER.ChromHMM_GenicEnhancer1.elements.bed
HEADNECK_ChromHMM_GenicEnhancer2	/data/talkowski/Samples/rCNVmap/data/master_annotations/noncoding/HEADNECK_MASTER.ChromHMM_GenicEnhancer2.elements.bed
HEADNECK_ChromHMM_Heterochromatin	/data/talkowski/Samples/rCNVmap/data/master_annotations/noncoding/HEADNECK_MASTER.ChromHMM_Heterochromatin.elements.bed
HEADNECK_ChromHMM_Quiescent	/data/talkowski/Samples/rCNVmap/data/master_annotations/noncoding/HEADNECK_MASTER.ChromHMM_Quiescent.elements.bed
HEADNECK_ChromHMM_RepressedPolycomb	/data/talkowski/Samples/rCNVmap/data/master_annotations/noncoding/HEADNECK_MASTER.ChromHMM_RepressedPolycomb.elements.bed
HEADNECK_ChromHMM_StrongTranscription	/data/talkowski/Samples/rCNVmap/data/master_annotations/noncoding/HEADNECK_MASTER.ChromHMM_StrongTranscription.elements.bed
HEADNECK_ChromHMM_TSSFlankDownstream	/data/talkowski/Samples/rCNVmap/data/master_annotations/noncoding/HEADNECK_MASTER.ChromHMM_TSSFlankDownstream.elements.bed
HEADNECK_ChromHMM_TSSFlankUpstream	/data/talkowski/Samples/rCNVmap/data/master_annotations/noncoding/HEADNECK_MASTER.ChromHMM_TSSFlankUpstream.elements.bed
HEADNECK_ChromHMM_WeakEnhancer	/data/talkowski/Samples/rCNVmap/data/master_annotations/noncoding/HEADNECK_MASTER.ChromHMM_WeakEnhancer.elements.bed
HEADNECK_ChromHMM_WeakRepressedPolycomb	/data/talkowski/Samples/rCNVmap/data/master_annotations/noncoding/HEADNECK_MASTER.ChromHMM_WeakRepressedPolycomb.elements.bed
HEADNECK_ChromHMM_WeakTranscription	/data/talkowski/Samples/rCNVmap/data/master_annotations/noncoding/HEADNECK_MASTER.ChromHMM_WeakTranscription.elements.bed
HEADNECK_ChromHMM_ZNFGenesRepeats	/data/talkowski/Samples/rCNVmap/data/master_annotations/noncoding/HEADNECK_MASTER.ChromHMM_ZNFGenesRepeats.elements.bed
HEADNECK_DHS	/data/talkowski/Samples/rCNVmap/data/master_annotations/noncoding/HEADNECK_MASTER.DHS.elements.bed
HEADNECK_Enhancer	/data/talkowski/Samples/rCNVmap/data/master_annotations/noncoding/HEADNECK_MASTER.Enhancer.elements.bed
HEADNECK_eQTLs	/data/talkowski/Samples/rCNVmap/data/master_annotations/noncoding/HEADNECK_MASTER.eQTLs.elements.bed
HEADNECK_H3K27ac	/data/talkowski/Samples/rCNVmap/data/master_annotations/noncoding/HEADNECK_MASTER.H3K27ac.elements.bed
HEADNECK_PMDs	/data/talkowski/Samples/rCNVmap/data/master_annotations/noncoding/HEADNECK_MASTER.PMDs.elements.bed
HEADNECK_StrongDHS	/data/talkowski/Samples/rCNVmap/data/master_annotations/noncoding/HEADNECK_MASTER.StrongDHS.elements.bed
HEADNECK_StrongH3K27ac	/data/talkowski/Samples/rCNVmap/data/master_annotations/noncoding/HEADNECK_MASTER.StrongH3K27ac.elements.bed
HEADNECK_SuperEnhancer	/data/talkowski/Samples/rCNVmap/data/master_annotations/noncoding/HEADNECK_MASTER.SuperEnhancer.elements.bed
HEART_ChromHMM_ActiveEnhancer1	/data/talkowski/Samples/rCNVmap/data/master_annotations/noncoding/HEART_MASTER.ChromHMM_ActiveEnhancer1.elements.bed
HEART_ChromHMM_ActiveEnhancer2	/data/talkowski/Samples/rCNVmap/data/master_annotations/noncoding/HEART_MASTER.ChromHMM_ActiveEnhancer2.elements.bed
HEART_ChromHMM_ActiveTSS	/data/talkowski/Samples/rCNVmap/data/master_annotations/noncoding/HEART_MASTER.ChromHMM_ActiveTSS.elements.bed
HEART_ChromHMM_ActiveTSSFlanks	/data/talkowski/Samples/rCNVmap/data/master_annotations/noncoding/HEART_MASTER.ChromHMM_ActiveTSSFlanks.elements.bed
HEART_ChromHMM_BivalentEnhancer	/data/talkowski/Samples/rCNVmap/data/master_annotations/noncoding/HEART_MASTER.ChromHMM_BivalentEnhancer.elements.bed
HEART_ChromHMM_BivalentPoisedTSS	/data/talkowski/Samples/rCNVmap/data/master_annotations/noncoding/HEART_MASTER.ChromHMM_BivalentPoisedTSS.elements.bed
HEART_ChromHMM_GenicEnhancer1	/data/talkowski/Samples/rCNVmap/data/master_annotations/noncoding/HEART_MASTER.ChromHMM_GenicEnhancer1.elements.bed
HEART_ChromHMM_GenicEnhancer2	/data/talkowski/Samples/rCNVmap/data/master_annotations/noncoding/HEART_MASTER.ChromHMM_GenicEnhancer2.elements.bed
HEART_ChromHMM_Heterochromatin	/data/talkowski/Samples/rCNVmap/data/master_annotations/noncoding/HEART_MASTER.ChromHMM_Heterochromatin.elements.bed
HEART_ChromHMM_Quiescent	/data/talkowski/Samples/rCNVmap/data/master_annotations/noncoding/HEART_MASTER.ChromHMM_Quiescent.elements.bed
HEART_ChromHMM_RepressedPolycomb	/data/talkowski/Samples/rCNVmap/data/master_annotations/noncoding/HEART_MASTER.ChromHMM_RepressedPolycomb.elements.bed
HEART_ChromHMM_StrongTranscription	/data/talkowski/Samples/rCNVmap/data/master_annotations/noncoding/HEART_MASTER.ChromHMM_StrongTranscription.elements.bed
HEART_ChromHMM_TSSFlankDownstream	/data/talkowski/Samples/rCNVmap/data/master_annotations/noncoding/HEART_MASTER.ChromHMM_TSSFlankDownstream.elements.bed
HEART_ChromHMM_TSSFlankUpstream	/data/talkowski/Samples/rCNVmap/data/master_annotations/noncoding/HEART_MASTER.ChromHMM_TSSFlankUpstream.elements.bed
HEART_ChromHMM_WeakEnhancer	/data/talkowski/Samples/rCNVmap/data/master_annotations/noncoding/HEART_MASTER.ChromHMM_WeakEnhancer.elements.bed
HEART_ChromHMM_WeakRepressedPolycomb	/data/talkowski/Samples/rCNVmap/data/master_annotations/noncoding/HEART_MASTER.ChromHMM_WeakRepressedPolycomb.elements.bed
HEART_ChromHMM_WeakTranscription	/data/talkowski/Samples/rCNVmap/data/master_annotations/noncoding/HEART_MASTER.ChromHMM_WeakTranscription.elements.bed
HEART_ChromHMM_ZNFGenesRepeats	/data/talkowski/Samples/rCNVmap/data/master_annotations/noncoding/HEART_MASTER.ChromHMM_ZNFGenesRepeats.elements.bed
HEART_CompartmentA	/data/talkowski/Samples/rCNVmap/data/master_annotations/noncoding/HEART_MASTER.CompartmentA.elements.bed
HEART_CompartmentB	/data/talkowski/Samples/rCNVmap/data/master_annotations/noncoding/HEART_MASTER.CompartmentB.elements.bed
HEART_DHS	/data/talkowski/Samples/rCNVmap/data/master_annotations/noncoding/HEART_MASTER.DHS.elements.bed
HEART_DMRs	/data/talkowski/Samples/rCNVmap/data/master_annotations/noncoding/HEART_MASTER.DMRs.elements.bed
HEART_Enhancer	/data/talkowski/Samples/rCNVmap/data/master_annotations/noncoding/HEART_MASTER.Enhancer.elements.bed
HEART_eQTLs	/data/talkowski/Samples/rCNVmap/data/master_annotations/noncoding/HEART_MASTER.eQTLs.elements.bed
HEART_FIRE	/data/talkowski/Samples/rCNVmap/data/master_annotations/noncoding/HEART_MASTER.FIRE.elements.bed
HEART_H3K27ac	/data/talkowski/Samples/rCNVmap/data/master_annotations/noncoding/HEART_MASTER.H3K27ac.elements.bed
HEART_PMDs	/data/talkowski/Samples/rCNVmap/data/master_annotations/noncoding/HEART_MASTER.PMDs.elements.bed
HEART_StrongDHS	/data/talkowski/Samples/rCNVmap/data/master_annotations/noncoding/HEART_MASTER.StrongDHS.elements.bed
HEART_StrongH3K27ac	/data/talkowski/Samples/rCNVmap/data/master_annotations/noncoding/HEART_MASTER.StrongH3K27ac.elements.bed
HEART_SuperEnhancer	/data/talkowski/Samples/rCNVmap/data/master_annotations/noncoding/HEART_MASTER.SuperEnhancer.elements.bed
HEART_TAD	/data/talkowski/Samples/rCNVmap/data/master_annotations/noncoding/HEART_MASTER.TAD.elements.bed
HEART_TBR	/data/talkowski/Samples/rCNVmap/data/master_annotations/noncoding/HEART_MASTER.TBR.elements.bed
IMMUNE_ChromHMM_ActiveEnhancer1	/data/talkowski/Samples/rCNVmap/data/master_annotations/noncoding/IMMUNE_MASTER.ChromHMM_ActiveEnhancer1.elements.bed
IMMUNE_ChromHMM_ActiveEnhancer2	/data/talkowski/Samples/rCNVmap/data/master_annotations/noncoding/IMMUNE_MASTER.ChromHMM_ActiveEnhancer2.elements.bed
IMMUNE_ChromHMM_ActiveTSS	/data/talkowski/Samples/rCNVmap/data/master_annotations/noncoding/IMMUNE_MASTER.ChromHMM_ActiveTSS.elements.bed
IMMUNE_ChromHMM_ActiveTSSFlanks	/data/talkowski/Samples/rCNVmap/data/master_annotations/noncoding/IMMUNE_MASTER.ChromHMM_ActiveTSSFlanks.elements.bed
IMMUNE_ChromHMM_BivalentEnhancer	/data/talkowski/Samples/rCNVmap/data/master_annotations/noncoding/IMMUNE_MASTER.ChromHMM_BivalentEnhancer.elements.bed
IMMUNE_ChromHMM_BivalentPoisedTSS	/data/talkowski/Samples/rCNVmap/data/master_annotations/noncoding/IMMUNE_MASTER.ChromHMM_BivalentPoisedTSS.elements.bed
IMMUNE_ChromHMM_GenicEnhancer1	/data/talkowski/Samples/rCNVmap/data/master_annotations/noncoding/IMMUNE_MASTER.ChromHMM_GenicEnhancer1.elements.bed
IMMUNE_ChromHMM_GenicEnhancer2	/data/talkowski/Samples/rCNVmap/data/master_annotations/noncoding/IMMUNE_MASTER.ChromHMM_GenicEnhancer2.elements.bed
IMMUNE_ChromHMM_Heterochromatin	/data/talkowski/Samples/rCNVmap/data/master_annotations/noncoding/IMMUNE_MASTER.ChromHMM_Heterochromatin.elements.bed
IMMUNE_ChromHMM_Quiescent	/data/talkowski/Samples/rCNVmap/data/master_annotations/noncoding/IMMUNE_MASTER.ChromHMM_Quiescent.elements.bed
IMMUNE_ChromHMM_RepressedPolycomb	/data/talkowski/Samples/rCNVmap/data/master_annotations/noncoding/IMMUNE_MASTER.ChromHMM_RepressedPolycomb.elements.bed
IMMUNE_ChromHMM_StrongTranscription	/data/talkowski/Samples/rCNVmap/data/master_annotations/noncoding/IMMUNE_MASTER.ChromHMM_StrongTranscription.elements.bed
IMMUNE_ChromHMM_TSSFlankDownstream	/data/talkowski/Samples/rCNVmap/data/master_annotations/noncoding/IMMUNE_MASTER.ChromHMM_TSSFlankDownstream.elements.bed
IMMUNE_ChromHMM_TSSFlankUpstream	/data/talkowski/Samples/rCNVmap/data/master_annotations/noncoding/IMMUNE_MASTER.ChromHMM_TSSFlankUpstream.elements.bed
IMMUNE_ChromHMM_WeakEnhancer	/data/talkowski/Samples/rCNVmap/data/master_annotations/noncoding/IMMUNE_MASTER.ChromHMM_WeakEnhancer.elements.bed
IMMUNE_ChromHMM_WeakRepressedPolycomb	/data/talkowski/Samples/rCNVmap/data/master_annotations/noncoding/IMMUNE_MASTER.ChromHMM_WeakRepressedPolycomb.elements.bed
IMMUNE_ChromHMM_WeakTranscription	/data/talkowski/Samples/rCNVmap/data/master_annotations/noncoding/IMMUNE_MASTER.ChromHMM_WeakTranscription.elements.bed
IMMUNE_ChromHMM_ZNFGenesRepeats	/data/talkowski/Samples/rCNVmap/data/master_annotations/noncoding/IMMUNE_MASTER.ChromHMM_ZNFGenesRepeats.elements.bed
IMMUNE_CompartmentA	/data/talkowski/Samples/rCNVmap/data/master_annotations/noncoding/IMMUNE_MASTER.CompartmentA.elements.bed
IMMUNE_CompartmentB	/data/talkowski/Samples/rCNVmap/data/master_annotations/noncoding/IMMUNE_MASTER.CompartmentB.elements.bed
IMMUNE_DHS	/data/talkowski/Samples/rCNVmap/data/master_annotations/noncoding/IMMUNE_MASTER.DHS.elements.bed
IMMUNE_DMRs	/data/talkowski/Samples/rCNVmap/data/master_annotations/noncoding/IMMUNE_MASTER.DMRs.elements.bed
IMMUNE_Enhancer	/data/talkowski/Samples/rCNVmap/data/master_annotations/noncoding/IMMUNE_MASTER.Enhancer.elements.bed
IMMUNE_eQTLs	/data/talkowski/Samples/rCNVmap/data/master_annotations/noncoding/IMMUNE_MASTER.eQTLs.elements.bed
IMMUNE_FIRE	/data/talkowski/Samples/rCNVmap/data/master_annotations/noncoding/IMMUNE_MASTER.FIRE.elements.bed
IMMUNE_H3K27ac	/data/talkowski/Samples/rCNVmap/data/master_annotations/noncoding/IMMUNE_MASTER.H3K27ac.elements.bed
IMMUNE_PMDs	/data/talkowski/Samples/rCNVmap/data/master_annotations/noncoding/IMMUNE_MASTER.PMDs.elements.bed
IMMUNE_StrongDHS	/data/talkowski/Samples/rCNVmap/data/master_annotations/noncoding/IMMUNE_MASTER.StrongDHS.elements.bed
IMMUNE_StrongH3K27ac	/data/talkowski/Samples/rCNVmap/data/master_annotations/noncoding/IMMUNE_MASTER.StrongH3K27ac.elements.bed
IMMUNE_SuperEnhancer	/data/talkowski/Samples/rCNVmap/data/master_annotations/noncoding/IMMUNE_MASTER.SuperEnhancer.elements.bed
IMMUNE_TAD	/data/talkowski/Samples/rCNVmap/data/master_annotations/noncoding/IMMUNE_MASTER.TAD.elements.bed
IMMUNE_TBR	/data/talkowski/Samples/rCNVmap/data/master_annotations/noncoding/IMMUNE_MASTER.TBR.elements.bed
LUNG_ChromHMM_ActiveEnhancer1	/data/talkowski/Samples/rCNVmap/data/master_annotations/noncoding/LUNG_MASTER.ChromHMM_ActiveEnhancer1.elements.bed
LUNG_ChromHMM_ActiveEnhancer2	/data/talkowski/Samples/rCNVmap/data/master_annotations/noncoding/LUNG_MASTER.ChromHMM_ActiveEnhancer2.elements.bed
LUNG_ChromHMM_ActiveTSS	/data/talkowski/Samples/rCNVmap/data/master_annotations/noncoding/LUNG_MASTER.ChromHMM_ActiveTSS.elements.bed
LUNG_ChromHMM_ActiveTSSFlanks	/data/talkowski/Samples/rCNVmap/data/master_annotations/noncoding/LUNG_MASTER.ChromHMM_ActiveTSSFlanks.elements.bed
LUNG_ChromHMM_BivalentEnhancer	/data/talkowski/Samples/rCNVmap/data/master_annotations/noncoding/LUNG_MASTER.ChromHMM_BivalentEnhancer.elements.bed
LUNG_ChromHMM_BivalentPoisedTSS	/data/talkowski/Samples/rCNVmap/data/master_annotations/noncoding/LUNG_MASTER.ChromHMM_BivalentPoisedTSS.elements.bed
LUNG_ChromHMM_GenicEnhancer1	/data/talkowski/Samples/rCNVmap/data/master_annotations/noncoding/LUNG_MASTER.ChromHMM_GenicEnhancer1.elements.bed
LUNG_ChromHMM_GenicEnhancer2	/data/talkowski/Samples/rCNVmap/data/master_annotations/noncoding/LUNG_MASTER.ChromHMM_GenicEnhancer2.elements.bed
LUNG_ChromHMM_Heterochromatin	/data/talkowski/Samples/rCNVmap/data/master_annotations/noncoding/LUNG_MASTER.ChromHMM_Heterochromatin.elements.bed
LUNG_ChromHMM_Quiescent	/data/talkowski/Samples/rCNVmap/data/master_annotations/noncoding/LUNG_MASTER.ChromHMM_Quiescent.elements.bed
LUNG_ChromHMM_RepressedPolycomb	/data/talkowski/Samples/rCNVmap/data/master_annotations/noncoding/LUNG_MASTER.ChromHMM_RepressedPolycomb.elements.bed
LUNG_ChromHMM_StrongTranscription	/data/talkowski/Samples/rCNVmap/data/master_annotations/noncoding/LUNG_MASTER.ChromHMM_StrongTranscription.elements.bed
LUNG_ChromHMM_TSSFlankDownstream	/data/talkowski/Samples/rCNVmap/data/master_annotations/noncoding/LUNG_MASTER.ChromHMM_TSSFlankDownstream.elements.bed
LUNG_ChromHMM_TSSFlankUpstream	/data/talkowski/Samples/rCNVmap/data/master_annotations/noncoding/LUNG_MASTER.ChromHMM_TSSFlankUpstream.elements.bed
LUNG_ChromHMM_WeakEnhancer	/data/talkowski/Samples/rCNVmap/data/master_annotations/noncoding/LUNG_MASTER.ChromHMM_WeakEnhancer.elements.bed
LUNG_ChromHMM_WeakRepressedPolycomb	/data/talkowski/Samples/rCNVmap/data/master_annotations/noncoding/LUNG_MASTER.ChromHMM_WeakRepressedPolycomb.elements.bed
LUNG_ChromHMM_WeakTranscription	/data/talkowski/Samples/rCNVmap/data/master_annotations/noncoding/LUNG_MASTER.ChromHMM_WeakTranscription.elements.bed
LUNG_ChromHMM_ZNFGenesRepeats	/data/talkowski/Samples/rCNVmap/data/master_annotations/noncoding/LUNG_MASTER.ChromHMM_ZNFGenesRepeats.elements.bed
LUNG_CompartmentA	/data/talkowski/Samples/rCNVmap/data/master_annotations/noncoding/LUNG_MASTER.CompartmentA.elements.bed
LUNG_CompartmentB	/data/talkowski/Samples/rCNVmap/data/master_annotations/noncoding/LUNG_MASTER.CompartmentB.elements.bed
LUNG_DHS	/data/talkowski/Samples/rCNVmap/data/master_annotations/noncoding/LUNG_MASTER.DHS.elements.bed
LUNG_Enhancer	/data/talkowski/Samples/rCNVmap/data/master_annotations/noncoding/LUNG_MASTER.Enhancer.elements.bed
LUNG_eQTLs	/data/talkowski/Samples/rCNVmap/data/master_annotations/noncoding/LUNG_MASTER.eQTLs.elements.bed
LUNG_FIRE	/data/talkowski/Samples/rCNVmap/data/master_annotations/noncoding/LUNG_MASTER.FIRE.elements.bed
LUNG_H3K27ac	/data/talkowski/Samples/rCNVmap/data/master_annotations/noncoding/LUNG_MASTER.H3K27ac.elements.bed
LUNG_PMDs	/data/talkowski/Samples/rCNVmap/data/master_annotations/noncoding/LUNG_MASTER.PMDs.elements.bed
LUNG_StrongDHS	/data/talkowski/Samples/rCNVmap/data/master_annotations/noncoding/LUNG_MASTER.StrongDHS.elements.bed
LUNG_StrongH3K27ac	/data/talkowski/Samples/rCNVmap/data/master_annotations/noncoding/LUNG_MASTER.StrongH3K27ac.elements.bed
LUNG_SuperEnhancer	/data/talkowski/Samples/rCNVmap/data/master_annotations/noncoding/LUNG_MASTER.SuperEnhancer.elements.bed
LUNG_TAD	/data/talkowski/Samples/rCNVmap/data/master_annotations/noncoding/LUNG_MASTER.TAD.elements.bed
LUNG_TBR	/data/talkowski/Samples/rCNVmap/data/master_annotations/noncoding/LUNG_MASTER.TBR.elements.bed
MUSCLE_ChromHMM_ActiveEnhancer1	/data/talkowski/Samples/rCNVmap/data/master_annotations/noncoding/MUSCLE_MASTER.ChromHMM_ActiveEnhancer1.elements.bed
MUSCLE_ChromHMM_ActiveEnhancer2	/data/talkowski/Samples/rCNVmap/data/master_annotations/noncoding/MUSCLE_MASTER.ChromHMM_ActiveEnhancer2.elements.bed
MUSCLE_ChromHMM_ActiveTSS	/data/talkowski/Samples/rCNVmap/data/master_annotations/noncoding/MUSCLE_MASTER.ChromHMM_ActiveTSS.elements.bed
MUSCLE_ChromHMM_ActiveTSSFlanks	/data/talkowski/Samples/rCNVmap/data/master_annotations/noncoding/MUSCLE_MASTER.ChromHMM_ActiveTSSFlanks.elements.bed
MUSCLE_ChromHMM_BivalentEnhancer	/data/talkowski/Samples/rCNVmap/data/master_annotations/noncoding/MUSCLE_MASTER.ChromHMM_BivalentEnhancer.elements.bed
MUSCLE_ChromHMM_BivalentPoisedTSS	/data/talkowski/Samples/rCNVmap/data/master_annotations/noncoding/MUSCLE_MASTER.ChromHMM_BivalentPoisedTSS.elements.bed
MUSCLE_ChromHMM_GenicEnhancer1	/data/talkowski/Samples/rCNVmap/data/master_annotations/noncoding/MUSCLE_MASTER.ChromHMM_GenicEnhancer1.elements.bed
MUSCLE_ChromHMM_GenicEnhancer2	/data/talkowski/Samples/rCNVmap/data/master_annotations/noncoding/MUSCLE_MASTER.ChromHMM_GenicEnhancer2.elements.bed
MUSCLE_ChromHMM_Heterochromatin	/data/talkowski/Samples/rCNVmap/data/master_annotations/noncoding/MUSCLE_MASTER.ChromHMM_Heterochromatin.elements.bed
MUSCLE_ChromHMM_Quiescent	/data/talkowski/Samples/rCNVmap/data/master_annotations/noncoding/MUSCLE_MASTER.ChromHMM_Quiescent.elements.bed
MUSCLE_ChromHMM_RepressedPolycomb	/data/talkowski/Samples/rCNVmap/data/master_annotations/noncoding/MUSCLE_MASTER.ChromHMM_RepressedPolycomb.elements.bed
MUSCLE_ChromHMM_StrongTranscription	/data/talkowski/Samples/rCNVmap/data/master_annotations/noncoding/MUSCLE_MASTER.ChromHMM_StrongTranscription.elements.bed
MUSCLE_ChromHMM_TSSFlankDownstream	/data/talkowski/Samples/rCNVmap/data/master_annotations/noncoding/MUSCLE_MASTER.ChromHMM_TSSFlankDownstream.elements.bed
MUSCLE_ChromHMM_TSSFlankUpstream	/data/talkowski/Samples/rCNVmap/data/master_annotations/noncoding/MUSCLE_MASTER.ChromHMM_TSSFlankUpstream.elements.bed
MUSCLE_ChromHMM_WeakEnhancer	/data/talkowski/Samples/rCNVmap/data/master_annotations/noncoding/MUSCLE_MASTER.ChromHMM_WeakEnhancer.elements.bed
MUSCLE_ChromHMM_WeakRepressedPolycomb	/data/talkowski/Samples/rCNVmap/data/master_annotations/noncoding/MUSCLE_MASTER.ChromHMM_WeakRepressedPolycomb.elements.bed
MUSCLE_ChromHMM_WeakTranscription	/data/talkowski/Samples/rCNVmap/data/master_annotations/noncoding/MUSCLE_MASTER.ChromHMM_WeakTranscription.elements.bed
MUSCLE_ChromHMM_ZNFGenesRepeats	/data/talkowski/Samples/rCNVmap/data/master_annotations/noncoding/MUSCLE_MASTER.ChromHMM_ZNFGenesRepeats.elements.bed
MUSCLE_CompartmentA	/data/talkowski/Samples/rCNVmap/data/master_annotations/noncoding/MUSCLE_MASTER.CompartmentA.elements.bed
MUSCLE_CompartmentB	/data/talkowski/Samples/rCNVmap/data/master_annotations/noncoding/MUSCLE_MASTER.CompartmentB.elements.bed
MUSCLE_DHS	/data/talkowski/Samples/rCNVmap/data/master_annotations/noncoding/MUSCLE_MASTER.DHS.elements.bed
MUSCLE_DMRs	/data/talkowski/Samples/rCNVmap/data/master_annotations/noncoding/MUSCLE_MASTER.DMRs.elements.bed
MUSCLE_Enhancer	/data/talkowski/Samples/rCNVmap/data/master_annotations/noncoding/MUSCLE_MASTER.Enhancer.elements.bed
MUSCLE_eQTLs	/data/talkowski/Samples/rCNVmap/data/master_annotations/noncoding/MUSCLE_MASTER.eQTLs.elements.bed
MUSCLE_FIRE	/data/talkowski/Samples/rCNVmap/data/master_annotations/noncoding/MUSCLE_MASTER.FIRE.elements.bed
MUSCLE_H3K27ac	/data/talkowski/Samples/rCNVmap/data/master_annotations/noncoding/MUSCLE_MASTER.H3K27ac.elements.bed
MUSCLE_PMDs	/data/talkowski/Samples/rCNVmap/data/master_annotations/noncoding/MUSCLE_MASTER.PMDs.elements.bed
MUSCLE_StrongDHS	/data/talkowski/Samples/rCNVmap/data/master_annotations/noncoding/MUSCLE_MASTER.StrongDHS.elements.bed
MUSCLE_StrongH3K27ac	/data/talkowski/Samples/rCNVmap/data/master_annotations/noncoding/MUSCLE_MASTER.StrongH3K27ac.elements.bed
MUSCLE_SuperEnhancer	/data/talkowski/Samples/rCNVmap/data/master_annotations/noncoding/MUSCLE_MASTER.SuperEnhancer.elements.bed
MUSCLE_TAD	/data/talkowski/Samples/rCNVmap/data/master_annotations/noncoding/MUSCLE_MASTER.TAD.elements.bed
MUSCLE_TBR	/data/talkowski/Samples/rCNVmap/data/master_annotations/noncoding/MUSCLE_MASTER.TBR.elements.bed
RENAL_CompartmentA	/data/talkowski/Samples/rCNVmap/data/master_annotations/noncoding/RENAL_MASTER.CompartmentA.elements.bed
RENAL_CompartmentB	/data/talkowski/Samples/rCNVmap/data/master_annotations/noncoding/RENAL_MASTER.CompartmentB.elements.bed
RENAL_DHS	/data/talkowski/Samples/rCNVmap/data/master_annotations/noncoding/RENAL_MASTER.DHS.elements.bed
RENAL_Enhancer	/data/talkowski/Samples/rCNVmap/data/master_annotations/noncoding/RENAL_MASTER.Enhancer.elements.bed
RENAL_FIRE	/data/talkowski/Samples/rCNVmap/data/master_annotations/noncoding/RENAL_MASTER.FIRE.elements.bed
RENAL_H3K27ac	/data/talkowski/Samples/rCNVmap/data/master_annotations/noncoding/RENAL_MASTER.H3K27ac.elements.bed
RENAL_PMDs	/data/talkowski/Samples/rCNVmap/data/master_annotations/noncoding/RENAL_MASTER.PMDs.elements.bed
RENAL_StrongDHS	/data/talkowski/Samples/rCNVmap/data/master_annotations/noncoding/RENAL_MASTER.StrongDHS.elements.bed
RENAL_StrongH3K27ac	/data/talkowski/Samples/rCNVmap/data/master_annotations/noncoding/RENAL_MASTER.StrongH3K27ac.elements.bed
RENAL_SuperEnhancer	/data/talkowski/Samples/rCNVmap/data/master_annotations/noncoding/RENAL_MASTER.SuperEnhancer.elements.bed
RENAL_TAD	/data/talkowski/Samples/rCNVmap/data/master_annotations/noncoding/RENAL_MASTER.TAD.elements.bed
RENAL_TBR	/data/talkowski/Samples/rCNVmap/data/master_annotations/noncoding/RENAL_MASTER.TBR.elements.bed
REPRO_ChromHMM_ActiveEnhancer1	/data/talkowski/Samples/rCNVmap/data/master_annotations/noncoding/REPRO_MASTER.ChromHMM_ActiveEnhancer1.elements.bed
REPRO_ChromHMM_ActiveEnhancer2	/data/talkowski/Samples/rCNVmap/data/master_annotations/noncoding/REPRO_MASTER.ChromHMM_ActiveEnhancer2.elements.bed
REPRO_ChromHMM_ActiveTSS	/data/talkowski/Samples/rCNVmap/data/master_annotations/noncoding/REPRO_MASTER.ChromHMM_ActiveTSS.elements.bed
REPRO_ChromHMM_ActiveTSSFlanks	/data/talkowski/Samples/rCNVmap/data/master_annotations/noncoding/REPRO_MASTER.ChromHMM_ActiveTSSFlanks.elements.bed
REPRO_ChromHMM_BivalentEnhancer	/data/talkowski/Samples/rCNVmap/data/master_annotations/noncoding/REPRO_MASTER.ChromHMM_BivalentEnhancer.elements.bed
REPRO_ChromHMM_BivalentPoisedTSS	/data/talkowski/Samples/rCNVmap/data/master_annotations/noncoding/REPRO_MASTER.ChromHMM_BivalentPoisedTSS.elements.bed
REPRO_ChromHMM_GenicEnhancer1	/data/talkowski/Samples/rCNVmap/data/master_annotations/noncoding/REPRO_MASTER.ChromHMM_GenicEnhancer1.elements.bed
REPRO_ChromHMM_GenicEnhancer2	/data/talkowski/Samples/rCNVmap/data/master_annotations/noncoding/REPRO_MASTER.ChromHMM_GenicEnhancer2.elements.bed
REPRO_ChromHMM_Heterochromatin	/data/talkowski/Samples/rCNVmap/data/master_annotations/noncoding/REPRO_MASTER.ChromHMM_Heterochromatin.elements.bed
REPRO_ChromHMM_Quiescent	/data/talkowski/Samples/rCNVmap/data/master_annotations/noncoding/REPRO_MASTER.ChromHMM_Quiescent.elements.bed
REPRO_ChromHMM_RepressedPolycomb	/data/talkowski/Samples/rCNVmap/data/master_annotations/noncoding/REPRO_MASTER.ChromHMM_RepressedPolycomb.elements.bed
REPRO_ChromHMM_StrongTranscription	/data/talkowski/Samples/rCNVmap/data/master_annotations/noncoding/REPRO_MASTER.ChromHMM_StrongTranscription.elements.bed
REPRO_ChromHMM_TSSFlankDownstream	/data/talkowski/Samples/rCNVmap/data/master_annotations/noncoding/REPRO_MASTER.ChromHMM_TSSFlankDownstream.elements.bed
REPRO_ChromHMM_TSSFlankUpstream	/data/talkowski/Samples/rCNVmap/data/master_annotations/noncoding/REPRO_MASTER.ChromHMM_TSSFlankUpstream.elements.bed
REPRO_ChromHMM_WeakEnhancer	/data/talkowski/Samples/rCNVmap/data/master_annotations/noncoding/REPRO_MASTER.ChromHMM_WeakEnhancer.elements.bed
REPRO_ChromHMM_WeakRepressedPolycomb	/data/talkowski/Samples/rCNVmap/data/master_annotations/noncoding/REPRO_MASTER.ChromHMM_WeakRepressedPolycomb.elements.bed
REPRO_ChromHMM_WeakTranscription	/data/talkowski/Samples/rCNVmap/data/master_annotations/noncoding/REPRO_MASTER.ChromHMM_WeakTranscription.elements.bed
REPRO_ChromHMM_ZNFGenesRepeats	/data/talkowski/Samples/rCNVmap/data/master_annotations/noncoding/REPRO_MASTER.ChromHMM_ZNFGenesRepeats.elements.bed
REPRO_CompartmentA	/data/talkowski/Samples/rCNVmap/data/master_annotations/noncoding/REPRO_MASTER.CompartmentA.elements.bed
REPRO_CompartmentB	/data/talkowski/Samples/rCNVmap/data/master_annotations/noncoding/REPRO_MASTER.CompartmentB.elements.bed
REPRO_DHS	/data/talkowski/Samples/rCNVmap/data/master_annotations/noncoding/REPRO_MASTER.DHS.elements.bed
REPRO_DMRs	/data/talkowski/Samples/rCNVmap/data/master_annotations/noncoding/REPRO_MASTER.DMRs.elements.bed
REPRO_Enhancer	/data/talkowski/Samples/rCNVmap/data/master_annotations/noncoding/REPRO_MASTER.Enhancer.elements.bed
REPRO_eQTLs	/data/talkowski/Samples/rCNVmap/data/master_annotations/noncoding/REPRO_MASTER.eQTLs.elements.bed
REPRO_FIRE	/data/talkowski/Samples/rCNVmap/data/master_annotations/noncoding/REPRO_MASTER.FIRE.elements.bed
REPRO_H3K27ac	/data/talkowski/Samples/rCNVmap/data/master_annotations/noncoding/REPRO_MASTER.H3K27ac.elements.bed
REPRO_PMDs	/data/talkowski/Samples/rCNVmap/data/master_annotations/noncoding/REPRO_MASTER.PMDs.elements.bed
REPRO_StrongDHS	/data/talkowski/Samples/rCNVmap/data/master_annotations/noncoding/REPRO_MASTER.StrongDHS.elements.bed
REPRO_StrongH3K27ac	/data/talkowski/Samples/rCNVmap/data/master_annotations/noncoding/REPRO_MASTER.StrongH3K27ac.elements.bed
REPRO_SuperEnhancer	/data/talkowski/Samples/rCNVmap/data/master_annotations/noncoding/REPRO_MASTER.SuperEnhancer.elements.bed
REPRO_TAD	/data/talkowski/Samples/rCNVmap/data/master_annotations/noncoding/REPRO_MASTER.TAD.elements.bed
REPRO_TBR	/data/talkowski/Samples/rCNVmap/data/master_annotations/noncoding/REPRO_MASTER.TBR.elements.bed
SKELETAL_ChromHMM_ActiveEnhancer1	/data/talkowski/Samples/rCNVmap/data/master_annotations/noncoding/SKELETAL_MASTER.ChromHMM_ActiveEnhancer1.elements.bed
SKELETAL_ChromHMM_ActiveEnhancer2	/data/talkowski/Samples/rCNVmap/data/master_annotations/noncoding/SKELETAL_MASTER.ChromHMM_ActiveEnhancer2.elements.bed
SKELETAL_ChromHMM_ActiveTSS	/data/talkowski/Samples/rCNVmap/data/master_annotations/noncoding/SKELETAL_MASTER.ChromHMM_ActiveTSS.elements.bed
SKELETAL_ChromHMM_ActiveTSSFlanks	/data/talkowski/Samples/rCNVmap/data/master_annotations/noncoding/SKELETAL_MASTER.ChromHMM_ActiveTSSFlanks.elements.bed
SKELETAL_ChromHMM_BivalentEnhancer	/data/talkowski/Samples/rCNVmap/data/master_annotations/noncoding/SKELETAL_MASTER.ChromHMM_BivalentEnhancer.elements.bed
SKELETAL_ChromHMM_BivalentPoisedTSS	/data/talkowski/Samples/rCNVmap/data/master_annotations/noncoding/SKELETAL_MASTER.ChromHMM_BivalentPoisedTSS.elements.bed
SKELETAL_ChromHMM_GenicEnhancer1	/data/talkowski/Samples/rCNVmap/data/master_annotations/noncoding/SKELETAL_MASTER.ChromHMM_GenicEnhancer1.elements.bed
SKELETAL_ChromHMM_GenicEnhancer2	/data/talkowski/Samples/rCNVmap/data/master_annotations/noncoding/SKELETAL_MASTER.ChromHMM_GenicEnhancer2.elements.bed
SKELETAL_ChromHMM_Heterochromatin	/data/talkowski/Samples/rCNVmap/data/master_annotations/noncoding/SKELETAL_MASTER.ChromHMM_Heterochromatin.elements.bed
SKELETAL_ChromHMM_Quiescent	/data/talkowski/Samples/rCNVmap/data/master_annotations/noncoding/SKELETAL_MASTER.ChromHMM_Quiescent.elements.bed
SKELETAL_ChromHMM_RepressedPolycomb	/data/talkowski/Samples/rCNVmap/data/master_annotations/noncoding/SKELETAL_MASTER.ChromHMM_RepressedPolycomb.elements.bed
SKELETAL_ChromHMM_StrongTranscription	/data/talkowski/Samples/rCNVmap/data/master_annotations/noncoding/SKELETAL_MASTER.ChromHMM_StrongTranscription.elements.bed
SKELETAL_ChromHMM_TSSFlankDownstream	/data/talkowski/Samples/rCNVmap/data/master_annotations/noncoding/SKELETAL_MASTER.ChromHMM_TSSFlankDownstream.elements.bed
SKELETAL_ChromHMM_TSSFlankUpstream	/data/talkowski/Samples/rCNVmap/data/master_annotations/noncoding/SKELETAL_MASTER.ChromHMM_TSSFlankUpstream.elements.bed
SKELETAL_ChromHMM_WeakEnhancer	/data/talkowski/Samples/rCNVmap/data/master_annotations/noncoding/SKELETAL_MASTER.ChromHMM_WeakEnhancer.elements.bed
SKELETAL_ChromHMM_WeakRepressedPolycomb	/data/talkowski/Samples/rCNVmap/data/master_annotations/noncoding/SKELETAL_MASTER.ChromHMM_WeakRepressedPolycomb.elements.bed
SKELETAL_ChromHMM_WeakTranscription	/data/talkowski/Samples/rCNVmap/data/master_annotations/noncoding/SKELETAL_MASTER.ChromHMM_WeakTranscription.elements.bed
SKELETAL_ChromHMM_ZNFGenesRepeats	/data/talkowski/Samples/rCNVmap/data/master_annotations/noncoding/SKELETAL_MASTER.ChromHMM_ZNFGenesRepeats.elements.bed
SKELETAL_DHS	/data/talkowski/Samples/rCNVmap/data/master_annotations/noncoding/SKELETAL_MASTER.DHS.elements.bed
SKELETAL_Enhancer	/data/talkowski/Samples/rCNVmap/data/master_annotations/noncoding/SKELETAL_MASTER.Enhancer.elements.bed
SKELETAL_StrongDHS	/data/talkowski/Samples/rCNVmap/data/master_annotations/noncoding/SKELETAL_MASTER.StrongDHS.elements.bed
SKELETAL_SuperEnhancer	/data/talkowski/Samples/rCNVmap/data/master_annotations/noncoding/SKELETAL_MASTER.SuperEnhancer.elements.bed
SKIN_ChromHMM_ActiveEnhancer1	/data/talkowski/Samples/rCNVmap/data/master_annotations/noncoding/SKIN_MASTER.ChromHMM_ActiveEnhancer1.elements.bed
SKIN_ChromHMM_ActiveEnhancer2	/data/talkowski/Samples/rCNVmap/data/master_annotations/noncoding/SKIN_MASTER.ChromHMM_ActiveEnhancer2.elements.bed
SKIN_ChromHMM_ActiveTSS	/data/talkowski/Samples/rCNVmap/data/master_annotations/noncoding/SKIN_MASTER.ChromHMM_ActiveTSS.elements.bed
SKIN_ChromHMM_ActiveTSSFlanks	/data/talkowski/Samples/rCNVmap/data/master_annotations/noncoding/SKIN_MASTER.ChromHMM_ActiveTSSFlanks.elements.bed
SKIN_ChromHMM_BivalentEnhancer	/data/talkowski/Samples/rCNVmap/data/master_annotations/noncoding/SKIN_MASTER.ChromHMM_BivalentEnhancer.elements.bed
SKIN_ChromHMM_BivalentPoisedTSS	/data/talkowski/Samples/rCNVmap/data/master_annotations/noncoding/SKIN_MASTER.ChromHMM_BivalentPoisedTSS.elements.bed
SKIN_ChromHMM_GenicEnhancer1	/data/talkowski/Samples/rCNVmap/data/master_annotations/noncoding/SKIN_MASTER.ChromHMM_GenicEnhancer1.elements.bed
SKIN_ChromHMM_GenicEnhancer2	/data/talkowski/Samples/rCNVmap/data/master_annotations/noncoding/SKIN_MASTER.ChromHMM_GenicEnhancer2.elements.bed
SKIN_ChromHMM_Heterochromatin	/data/talkowski/Samples/rCNVmap/data/master_annotations/noncoding/SKIN_MASTER.ChromHMM_Heterochromatin.elements.bed
SKIN_ChromHMM_Quiescent	/data/talkowski/Samples/rCNVmap/data/master_annotations/noncoding/SKIN_MASTER.ChromHMM_Quiescent.elements.bed
SKIN_ChromHMM_RepressedPolycomb	/data/talkowski/Samples/rCNVmap/data/master_annotations/noncoding/SKIN_MASTER.ChromHMM_RepressedPolycomb.elements.bed
SKIN_ChromHMM_StrongTranscription	/data/talkowski/Samples/rCNVmap/data/master_annotations/noncoding/SKIN_MASTER.ChromHMM_StrongTranscription.elements.bed
SKIN_ChromHMM_TSSFlankDownstream	/data/talkowski/Samples/rCNVmap/data/master_annotations/noncoding/SKIN_MASTER.ChromHMM_TSSFlankDownstream.elements.bed
SKIN_ChromHMM_TSSFlankUpstream	/data/talkowski/Samples/rCNVmap/data/master_annotations/noncoding/SKIN_MASTER.ChromHMM_TSSFlankUpstream.elements.bed
SKIN_ChromHMM_WeakEnhancer	/data/talkowski/Samples/rCNVmap/data/master_annotations/noncoding/SKIN_MASTER.ChromHMM_WeakEnhancer.elements.bed
SKIN_ChromHMM_WeakRepressedPolycomb	/data/talkowski/Samples/rCNVmap/data/master_annotations/noncoding/SKIN_MASTER.ChromHMM_WeakRepressedPolycomb.elements.bed
SKIN_ChromHMM_WeakTranscription	/data/talkowski/Samples/rCNVmap/data/master_annotations/noncoding/SKIN_MASTER.ChromHMM_WeakTranscription.elements.bed
SKIN_ChromHMM_ZNFGenesRepeats	/data/talkowski/Samples/rCNVmap/data/master_annotations/noncoding/SKIN_MASTER.ChromHMM_ZNFGenesRepeats.elements.bed
SKIN_CompartmentA	/data/talkowski/Samples/rCNVmap/data/master_annotations/noncoding/SKIN_MASTER.CompartmentA.elements.bed
SKIN_CompartmentB	/data/talkowski/Samples/rCNVmap/data/master_annotations/noncoding/SKIN_MASTER.CompartmentB.elements.bed
SKIN_DHS	/data/talkowski/Samples/rCNVmap/data/master_annotations/noncoding/SKIN_MASTER.DHS.elements.bed
SKIN_Enhancer	/data/talkowski/Samples/rCNVmap/data/master_annotations/noncoding/SKIN_MASTER.Enhancer.elements.bed
SKIN_eQTLs	/data/talkowski/Samples/rCNVmap/data/master_annotations/noncoding/SKIN_MASTER.eQTLs.elements.bed
SKIN_FIRE	/data/talkowski/Samples/rCNVmap/data/master_annotations/noncoding/SKIN_MASTER.FIRE.elements.bed
SKIN_H3K27ac	/data/talkowski/Samples/rCNVmap/data/master_annotations/noncoding/SKIN_MASTER.H3K27ac.elements.bed
SKIN_StrongDHS	/data/talkowski/Samples/rCNVmap/data/master_annotations/noncoding/SKIN_MASTER.StrongDHS.elements.bed
SKIN_StrongH3K27ac	/data/talkowski/Samples/rCNVmap/data/master_annotations/noncoding/SKIN_MASTER.StrongH3K27ac.elements.bed
SKIN_SuperEnhancer	/data/talkowski/Samples/rCNVmap/data/master_annotations/noncoding/SKIN_MASTER.SuperEnhancer.elements.bed
SKIN_TAD	/data/talkowski/Samples/rCNVmap/data/master_annotations/noncoding/SKIN_MASTER.TAD.elements.bed
SKIN_TBR	/data/talkowski/Samples/rCNVmap/data/master_annotations/noncoding/SKIN_MASTER.TBR.elements.bed