Constrained_genes	/data/talkowski/Samples/rCNVmap/data/master_annotations/genelists/ExAC_constrained.genes.list	/data/talkowski/Samples/rCNVmap/data/master_annotations/genelists/Gencode_v19_protein_coding.genes.list
Haplosufficient_genes	/data/talkowski/Samples/rCNVmap/data/master_annotations/genelists/ExAC_haplosufficient.genes.list	/data/talkowski/Samples/rCNVmap/data/master_annotations/genelists/Gencode_v19_protein_coding.genes.list
Not_clearly_haplosufficient_genes	/data/talkowski/Samples/rCNVmap/data/master_annotations/genelists/ExAC_notHaplosufficient.genes.list	/data/talkowski/Samples/rCNVmap/data/master_annotations/genelists/Gencode_v19_protein_coding.genes.list
Highly_constrained_genes	/data/talkowski/Samples/rCNVmap/data/master_annotations/genelists/ExAC_highly_constrained.genes.list	/data/talkowski/Samples/rCNVmap/data/master_annotations/genelists/Gencode_v19_protein_coding.genes.list
Extremely_constrained_genes	/data/talkowski/Samples/rCNVmap/data/master_annotations/genelists/ExAC_extremely_constrained.genes.list	/data/talkowski/Samples/rCNVmap/data/master_annotations/genelists/Gencode_v19_protein_coding.genes.list
Intolerant_genes	/data/talkowski/Samples/rCNVmap/data/master_annotations/genelists/RVIS_intolerant.genes.list	/data/talkowski/Samples/rCNVmap/data/master_annotations/genelists/Gencode_v19_protein_coding.genes.list
Highly_intolerant_genes	/data/talkowski/Samples/rCNVmap/data/master_annotations/genelists/RVIS_highly_intolerant.genes.list	/data/talkowski/Samples/rCNVmap/data/master_annotations/genelists/Gencode_v19_protein_coding.genes.list
Extremely_intolerant_genes	/data/talkowski/Samples/rCNVmap/data/master_annotations/genelists/RVIS_extremely_intolerant.genes.list	/data/talkowski/Samples/rCNVmap/data/master_annotations/genelists/Gencode_v19_protein_coding.genes.list
All_Gencode_genes	/data/talkowski/Samples/rCNVmap/data/master_annotations/genelists/Gencode_v19_all.genes.list	/data/talkowski/Samples/rCNVmap/data/master_annotations/genelists/Gencode_v19_all.genes.list
All_protein_coding_genes	/data/talkowski/Samples/rCNVmap/data/master_annotations/genelists/Gencode_v19_protein_coding.genes.list	/data/talkowski/Samples/rCNVmap/data/master_annotations/genelists/Gencode_v19_all.genes.list
All_antisense_RNAs	/data/talkowski/Samples/rCNVmap/data/master_annotations/genelists/Gencode_v19_antisense.genes.list	/data/talkowski/Samples/rCNVmap/data/master_annotations/genelists/Gencode_v19_all.genes.list
All_lincRNAs	/data/talkowski/Samples/rCNVmap/data/master_annotations/genelists/Gencode_v19_lincRNA.genes.list	/data/talkowski/Samples/rCNVmap/data/master_annotations/genelists/Gencode_v19_all.genes.list
All_miRNAs	/data/talkowski/Samples/rCNVmap/data/master_annotations/genelists/Gencode_v19_miRNA.genes.list	/data/talkowski/Samples/rCNVmap/data/master_annotations/genelists/Gencode_v19_all.genes.list
All_pseudogenes	/data/talkowski/Samples/rCNVmap/data/master_annotations/genelists/Gencode_v19_pseudogene.genes.list	/data/talkowski/Samples/rCNVmap/data/master_annotations/genelists/Gencode_v19_all.genes.list
All_snoRNAs	/data/talkowski/Samples/rCNVmap/data/master_annotations/genelists/Gencode_v19_snoRNA.genes.list	/data/talkowski/Samples/rCNVmap/data/master_annotations/genelists/Gencode_v19_all.genes.list
All_snRNAs	/data/talkowski/Samples/rCNVmap/data/master_annotations/genelists/Gencode_v19_snRNA.genes.list	/data/talkowski/Samples/rCNVmap/data/master_annotations/genelists/Gencode_v19_all.genes.list
FDA_approved_drug_targets	/data/talkowski/Samples/rCNVmap/data/master_annotations/genelists/FDA_drug_targets.genes.list	/data/talkowski/Samples/rCNVmap/data/master_annotations/genelists/Gencode_v19_protein_coding.genes.list
Autosomal_dominant_disease_genes	/data/talkowski/Samples/rCNVmap/data/master_annotations/genelists/autosomal_dominant_disease.genes.list	/data/talkowski/Samples/rCNVmap/data/master_annotations/genelists/Gencode_v19_protein_coding.genes.list
Autosomal_recessive_disease_genes	/data/talkowski/Samples/rCNVmap/data/master_annotations/genelists/autosomal_recessive_disease.genes.list	/data/talkowski/Samples/rCNVmap/data/master_annotations/genelists/Gencode_v19_protein_coding.genes.list
Culture_essential_genes	/data/talkowski/Samples/rCNVmap/data/master_annotations/genelists/Culture_essential.genes.list	/data/talkowski/Samples/rCNVmap/data/master_annotations/genelists/Gencode_v19_protein_coding.genes.list
DNA_repair_genes	/data/talkowski/Samples/rCNVmap/data/master_annotations/genelists/DNA_repair.genes.list	/data/talkowski/Samples/rCNVmap/data/master_annotations/genelists/Gencode_v19_protein_coding.genes.list
Germline_disease_associated_genes	/data/talkowski/Samples/rCNVmap/data/master_annotations/genelists/Germline_disease_HPO_associated.genes.list	/data/talkowski/Samples/rCNVmap/data/master_annotations/genelists/Gencode_v19_protein_coding.genes.list
Neurological_defect_associated_genes	/data/talkowski/Samples/rCNVmap/data/master_annotations/genelists/Neurological_defect_HPO_associated.genes.list	/data/talkowski/Samples/rCNVmap/data/master_annotations/genelists/Gencode_v19_protein_coding.genes.list
Neurodevelopmental_disorder_associated_genes	/data/talkowski/Samples/rCNVmap/data/master_annotations/genelists/Neurodevelopmental_disorder_HPO_associated.genes.list	/data/talkowski/Samples/rCNVmap/data/master_annotations/genelists/Gencode_v19_protein_coding.genes.list
Autism_spectrum_disorder_associated_genes	/data/talkowski/Samples/rCNVmap/data/master_annotations/genelists/Autism_spectrum_disorder_HPO_associated.genes.list	/data/talkowski/Samples/rCNVmap/data/master_annotations/genelists/Gencode_v19_protein_coding.genes.list
Developmental_delay_associated_genes	/data/talkowski/Samples/rCNVmap/data/master_annotations/genelists/Developmental_delay_HPO_associated.genes.list	/data/talkowski/Samples/rCNVmap/data/master_annotations/genelists/Gencode_v19_protein_coding.genes.list
Intellectual_disability_associated_genes	/data/talkowski/Samples/rCNVmap/data/master_annotations/genelists/Intellectual_disability_HPO_associated.genes.list	/data/talkowski/Samples/rCNVmap/data/master_annotations/genelists/Gencode_v19_protein_coding.genes.list
Neuropsychiatric_disorder_associated_genes	/data/talkowski/Samples/rCNVmap/data/master_annotations/genelists/Neuropsychiatric_disorder_HPO_associated.genes.list	/data/talkowski/Samples/rCNVmap/data/master_annotations/genelists/Gencode_v19_protein_coding.genes.list
Schizophrenia_associated_genes	/data/talkowski/Samples/rCNVmap/data/master_annotations/genelists/Schizophrenia_HPO_associated.genes.list	/data/talkowski/Samples/rCNVmap/data/master_annotations/genelists/Gencode_v19_protein_coding.genes.list
Behavioral_abnormality_other_associated_genes	/data/talkowski/Samples/rCNVmap/data/master_annotations/genelists/Behavioral_abnormality_other_HPO_associated.genes.list	/data/talkowski/Samples/rCNVmap/data/master_annotations/genelists/Gencode_v19_protein_coding.genes.list
Seizures_associated_genes	/data/talkowski/Samples/rCNVmap/data/master_annotations/genelists/Seizures_HPO_associated.genes.list	/data/talkowski/Samples/rCNVmap/data/master_annotations/genelists/Gencode_v19_protein_coding.genes.list
Hypotonia_associated_genes	/data/talkowski/Samples/rCNVmap/data/master_annotations/genelists/Hypotonia_HPO_associated.genes.list	/data/talkowski/Samples/rCNVmap/data/master_annotations/genelists/Gencode_v19_protein_coding.genes.list
Nonneurological_defect_associated_genes	/data/talkowski/Samples/rCNVmap/data/master_annotations/genelists/Nonneurological_defect_HPO_associated.genes.list	/data/talkowski/Samples/rCNVmap/data/master_annotations/genelists/Gencode_v19_protein_coding.genes.list
Digestive_respiratory_or_urinary_defect_associated_genes	/data/talkowski/Samples/rCNVmap/data/master_annotations/genelists/Digestive_respiratory_or_urinary_defect_HPO_associated.genes.list	/data/talkowski/Samples/rCNVmap/data/master_annotations/genelists/Gencode_v19_protein_coding.genes.list
Growth_defect_associated_genes	/data/talkowski/Samples/rCNVmap/data/master_annotations/genelists/Growth_defect_HPO_associated.genes.list	/data/talkowski/Samples/rCNVmap/data/master_annotations/genelists/Gencode_v19_protein_coding.genes.list
Integument_defect_associated_genes	/data/talkowski/Samples/rCNVmap/data/master_annotations/genelists/Integument_defect_HPO_associated.genes.list	/data/talkowski/Samples/rCNVmap/data/master_annotations/genelists/Gencode_v19_protein_coding.genes.list
Skeletal_defect_associated_genes	/data/talkowski/Samples/rCNVmap/data/master_annotations/genelists/Skeletal_defect_HPO_associated.genes.list	/data/talkowski/Samples/rCNVmap/data/master_annotations/genelists/Gencode_v19_protein_coding.genes.list
Head_or_neck_defect_associated_genes	/data/talkowski/Samples/rCNVmap/data/master_annotations/genelists/Head_or_neck_defect_HPO_associated.genes.list	/data/talkowski/Samples/rCNVmap/data/master_annotations/genelists/Gencode_v19_protein_coding.genes.list
Muscular_defect_associated_genes	/data/talkowski/Samples/rCNVmap/data/master_annotations/genelists/Muscular_defect_HPO_associated.genes.list	/data/talkowski/Samples/rCNVmap/data/master_annotations/genelists/Gencode_v19_protein_coding.genes.list
Cardiac_defect_associated_genes	/data/talkowski/Samples/rCNVmap/data/master_annotations/genelists/Cardiac_defect_HPO_associated.genes.list	/data/talkowski/Samples/rCNVmap/data/master_annotations/genelists/Gencode_v19_protein_coding.genes.list
Eye_or_ear_defect_associated_genes	/data/talkowski/Samples/rCNVmap/data/master_annotations/genelists/Eye_or_ear_defect_HPO_associated.genes.list	/data/talkowski/Samples/rCNVmap/data/master_annotations/genelists/Gencode_v19_protein_coding.genes.list
Endocrine_metabolic_or_immune_defect_associated_genes	/data/talkowski/Samples/rCNVmap/data/master_annotations/genelists/Endocrine_metabolic_or_immune_defect_HPO_associated.genes.list	/data/talkowski/Samples/rCNVmap/data/master_annotations/genelists/Gencode_v19_protein_coding.genes.list
Cancer_associated_genes	/data/talkowski/Samples/rCNVmap/data/master_annotations/genelists/Cancer_HPO_associated.genes.list	/data/talkowski/Samples/rCNVmap/data/master_annotations/genelists/Gencode_v19_protein_coding.genes.list
Liver_cancer_associated_genes	/data/talkowski/Samples/rCNVmap/data/master_annotations/genelists/Liver_cancer_HPO_associated.genes.list	/data/talkowski/Samples/rCNVmap/data/master_annotations/genelists/Gencode_v19_protein_coding.genes.list
Brain_cancer_associated_genes	/data/talkowski/Samples/rCNVmap/data/master_annotations/genelists/Brain_cancer_HPO_associated.genes.list	/data/talkowski/Samples/rCNVmap/data/master_annotations/genelists/Gencode_v19_protein_coding.genes.list
Blood_cancer_associated_genes	/data/talkowski/Samples/rCNVmap/data/master_annotations/genelists/Blood_cancer_HPO_associated.genes.list	/data/talkowski/Samples/rCNVmap/data/master_annotations/genelists/Gencode_v19_protein_coding.genes.list
Gastrointestinal_cancer_associated_genes	/data/talkowski/Samples/rCNVmap/data/master_annotations/genelists/Gastrointestinal_cancer_HPO_associated.genes.list	/data/talkowski/Samples/rCNVmap/data/master_annotations/genelists/Gencode_v19_protein_coding.genes.list
Skin_cancer_associated_genes	/data/talkowski/Samples/rCNVmap/data/master_annotations/genelists/Skin_cancer_HPO_associated.genes.list	/data/talkowski/Samples/rCNVmap/data/master_annotations/genelists/Gencode_v19_protein_coding.genes.list
Renal_cancer_associated_genes	/data/talkowski/Samples/rCNVmap/data/master_annotations/genelists/Renal_cancer_HPO_associated.genes.list	/data/talkowski/Samples/rCNVmap/data/master_annotations/genelists/Gencode_v19_protein_coding.genes.list
Musculoskeletal_cancer_associated_genes	/data/talkowski/Samples/rCNVmap/data/master_annotations/genelists/Musculoskeletal_cancer_HPO_associated.genes.list	/data/talkowski/Samples/rCNVmap/data/master_annotations/genelists/Gencode_v19_protein_coding.genes.list
Genital_cancer_associated_genes	/data/talkowski/Samples/rCNVmap/data/master_annotations/genelists/Genital_cancer_HPO_associated.genes.list	/data/talkowski/Samples/rCNVmap/data/master_annotations/genelists/Gencode_v19_protein_coding.genes.list
Head_or_neck_cancer_associated_genes	/data/talkowski/Samples/rCNVmap/data/master_annotations/genelists/Head_or_neck_cancer_HPO_associated.genes.list	/data/talkowski/Samples/rCNVmap/data/master_annotations/genelists/Gencode_v19_protein_coding.genes.list
Breast_cancer_associated_genes	/data/talkowski/Samples/rCNVmap/data/master_annotations/genelists/Breast_cancer_HPO_associated.genes.list	/data/talkowski/Samples/rCNVmap/data/master_annotations/genelists/Gencode_v19_protein_coding.genes.list
Lung_cancer_associated_genes	/data/talkowski/Samples/rCNVmap/data/master_annotations/genelists/Lung_cancer_HPO_associated.genes.list	/data/talkowski/Samples/rCNVmap/data/master_annotations/genelists/Gencode_v19_protein_coding.genes.list
Endocrine_cancer_associated_genes	/data/talkowski/Samples/rCNVmap/data/master_annotations/genelists/Endocrine_cancer_HPO_associated.genes.list	/data/talkowski/Samples/rCNVmap/data/master_annotations/genelists/Gencode_v19_protein_coding.genes.list
Genes_nearest_GWAS_loci	/data/talkowski/Samples/rCNVmap/data/master_annotations/genelists/GWAS_nearest.genes.list	/data/talkowski/Samples/rCNVmap/data/master_annotations/genelists/Gencode_v19_protein_coding.genes.list
High_confidence_haploinsufficient_genes	/data/talkowski/Samples/rCNVmap/data/master_annotations/genelists/ClinGen_haploinsufficient_high_confidence.genes.list	/data/talkowski/Samples/rCNVmap/data/master_annotations/genelists/Gencode_v19_protein_coding.genes.list
Medium_confidence_haploinsufficient_genes	/data/talkowski/Samples/rCNVmap/data/master_annotations/genelists/ClinGen_haploinsufficient_medium_confidence.genes.list	/data/talkowski/Samples/rCNVmap/data/master_annotations/genelists/Gencode_v19_protein_coding.genes.list
Low_confidence_haploinsufficient_genes	/data/talkowski/Samples/rCNVmap/data/master_annotations/genelists/ClinGen_haploinsufficient_low_confidence.genes.list	/data/talkowski/Samples/rCNVmap/data/master_annotations/genelists/Gencode_v19_protein_coding.genes.list
Olfactory_receptor_genes	/data/talkowski/Samples/rCNVmap/data/master_annotations/genelists/Olfactory_receptors.genes.list	/data/talkowski/Samples/rCNVmap/data/master_annotations/genelists/Gencode_v19_protein_coding.genes.list
ClinVar_disease_associated_genes	/data/talkowski/Samples/rCNVmap/data/master_annotations/genelists/ClinVar_disease_associated.genes.list	/data/talkowski/Samples/rCNVmap/data/master_annotations/genelists/Gencode_v19_protein_coding.genes.list
Kinases	/data/talkowski/Samples/rCNVmap/data/master_annotations/genelists/Kinases.genes.list	/data/talkowski/Samples/rCNVmap/data/master_annotations/genelists/Gencode_v19_protein_coding.genes.list
G_protein_coupled_receptors	/data/talkowski/Samples/rCNVmap/data/master_annotations/genelists/GPCRs.genes.list	/data/talkowski/Samples/rCNVmap/data/master_annotations/genelists/Gencode_v19_protein_coding.genes.list
Hereditary_cancer_risk_genes	/data/talkowski/Samples/rCNVmap/data/master_annotations/genelists/UWashington_cancer_panel.genes.list	/data/talkowski/Samples/rCNVmap/data/master_annotations/genelists/Gencode_v19_protein_coding.genes.list
Immunodeficiency_genes	/data/talkowski/Samples/rCNVmap/data/master_annotations/genelists/UWashington_immunodeficiency_panel.genes.list	/data/talkowski/Samples/rCNVmap/data/master_annotations/genelists/Gencode_v19_protein_coding.genes.list
GO_synapse_organization_genes	/data/talkowski/Samples/rCNVmap/data/master_annotations/genelists/GO_synapse_organization.genes.list	/data/talkowski/Samples/rCNVmap/data/master_annotations/genelists/Gencode_v19_protein_coding.genes.list
GO_dna_binding_genes	/data/talkowski/Samples/rCNVmap/data/master_annotations/genelists/GO_dna_binding.genes.list	/data/talkowski/Samples/rCNVmap/data/master_annotations/genelists/Gencode_v19_protein_coding.genes.list
GO_rna_binding_genes	/data/talkowski/Samples/rCNVmap/data/master_annotations/genelists/GO_rna_binding.genes.list	/data/talkowski/Samples/rCNVmap/data/master_annotations/genelists/Gencode_v19_protein_coding.genes.list
GO_regulation_of_transcription_dna_templated_genes	/data/talkowski/Samples/rCNVmap/data/master_annotations/genelists/GO_regulation_of_transcription__dna_templated.genes.list	/data/talkowski/Samples/rCNVmap/data/master_annotations/genelists/Gencode_v19_protein_coding.genes.list
GO_transcription_factor_activity_sequence_specific_dna_binding_genes	/data/talkowski/Samples/rCNVmap/data/master_annotations/genelists/GO_transcription_factor_activity__sequence_specific_dna_binding.genes.list	/data/talkowski/Samples/rCNVmap/data/master_annotations/genelists/Gencode_v19_protein_coding.genes.list
GO_chromatin_binding_genes	/data/talkowski/Samples/rCNVmap/data/master_annotations/genelists/GO_chromatin_binding.genes.list	/data/talkowski/Samples/rCNVmap/data/master_annotations/genelists/Gencode_v19_protein_coding.genes.list
GO_rna_splicing_genes	/data/talkowski/Samples/rCNVmap/data/master_annotations/genelists/GO_rna_splicing.genes.list	/data/talkowski/Samples/rCNVmap/data/master_annotations/genelists/Gencode_v19_protein_coding.genes.list
GO_mrna_processing_genes	/data/talkowski/Samples/rCNVmap/data/master_annotations/genelists/GO_mrna_processing.genes.list	/data/talkowski/Samples/rCNVmap/data/master_annotations/genelists/Gencode_v19_protein_coding.genes.list
GO_chromatin_genes	/data/talkowski/Samples/rCNVmap/data/master_annotations/genelists/GO_chromatin.genes.list	/data/talkowski/Samples/rCNVmap/data/master_annotations/genelists/Gencode_v19_protein_coding.genes.list
GO_histone_binding_genes	/data/talkowski/Samples/rCNVmap/data/master_annotations/genelists/GO_histone_binding.genes.list	/data/talkowski/Samples/rCNVmap/data/master_annotations/genelists/Gencode_v19_protein_coding.genes.list
GO_chromatin_remodeling_genes	/data/talkowski/Samples/rCNVmap/data/master_annotations/genelists/GO_chromatin_remodeling.genes.list	/data/talkowski/Samples/rCNVmap/data/master_annotations/genelists/Gencode_v19_protein_coding.genes.list
GO_methylation_genes	/data/talkowski/Samples/rCNVmap/data/master_annotations/genelists/GO_methylation.genes.list	/data/talkowski/Samples/rCNVmap/data/master_annotations/genelists/Gencode_v19_protein_coding.genes.list
GO_methyltransferase_activity_genes	/data/talkowski/Samples/rCNVmap/data/master_annotations/genelists/GO_methyltransferase_activity.genes.list	/data/talkowski/Samples/rCNVmap/data/master_annotations/genelists/Gencode_v19_protein_coding.genes.list
GO_proteolysis_genes	/data/talkowski/Samples/rCNVmap/data/master_annotations/genelists/GO_proteolysis.genes.list	/data/talkowski/Samples/rCNVmap/data/master_annotations/genelists/Gencode_v19_protein_coding.genes.list
GO_cell_differentiation_genes	/data/talkowski/Samples/rCNVmap/data/master_annotations/genelists/GO_cell_differentiation.genes.list	/data/talkowski/Samples/rCNVmap/data/master_annotations/genelists/Gencode_v19_protein_coding.genes.list
GO_cell_adhesion_genes	/data/talkowski/Samples/rCNVmap/data/master_annotations/genelists/GO_cell_adhesion.genes.list	/data/talkowski/Samples/rCNVmap/data/master_annotations/genelists/Gencode_v19_protein_coding.genes.list
GO_cytoskeleton_genes	/data/talkowski/Samples/rCNVmap/data/master_annotations/genelists/GO_cytoskeleton.genes.list	/data/talkowski/Samples/rCNVmap/data/master_annotations/genelists/Gencode_v19_protein_coding.genes.list
GO_extracellular_matrix_genes	/data/talkowski/Samples/rCNVmap/data/master_annotations/genelists/GO_extracellular_matrix.genes.list	/data/talkowski/Samples/rCNVmap/data/master_annotations/genelists/Gencode_v19_protein_coding.genes.list
GO_dna_repair_genes	/data/talkowski/Samples/rCNVmap/data/master_annotations/genelists/GO_dna_repair.genes.list	/data/talkowski/Samples/rCNVmap/data/master_annotations/genelists/Gencode_v19_protein_coding.genes.list
GO_translation_genes	/data/talkowski/Samples/rCNVmap/data/master_annotations/genelists/GO_translation.genes.list	/data/talkowski/Samples/rCNVmap/data/master_annotations/genelists/Gencode_v19_protein_coding.genes.list
GO_protein_folding_genes	/data/talkowski/Samples/rCNVmap/data/master_annotations/genelists/GO_protein_folding.genes.list	/data/talkowski/Samples/rCNVmap/data/master_annotations/genelists/Gencode_v19_protein_coding.genes.list
GO_autophagy_genes	/data/talkowski/Samples/rCNVmap/data/master_annotations/genelists/GO_autophagy.genes.list	/data/talkowski/Samples/rCNVmap/data/master_annotations/genelists/Gencode_v19_protein_coding.genes.list
GO_dna_recombination_genes	/data/talkowski/Samples/rCNVmap/data/master_annotations/genelists/GO_dna_recombination.genes.list	/data/talkowski/Samples/rCNVmap/data/master_annotations/genelists/Gencode_v19_protein_coding.genes.list
GO_regulation_of_translation_genes	/data/talkowski/Samples/rCNVmap/data/master_annotations/genelists/GO_regulation_of_translation.genes.list	/data/talkowski/Samples/rCNVmap/data/master_annotations/genelists/Gencode_v19_protein_coding.genes.list
GO_protein_localization_genes	/data/talkowski/Samples/rCNVmap/data/master_annotations/genelists/GO_protein_localization.genes.list	/data/talkowski/Samples/rCNVmap/data/master_annotations/genelists/Gencode_v19_protein_coding.genes.list
GO_metabolic_process_genes	/data/talkowski/Samples/rCNVmap/data/master_annotations/genelists/GO_metabolic_process.genes.list	/data/talkowski/Samples/rCNVmap/data/master_annotations/genelists/Gencode_v19_protein_coding.genes.list
GO_apoptotic_process_genes	/data/talkowski/Samples/rCNVmap/data/master_annotations/genelists/GO_apoptotic_process.genes.list	/data/talkowski/Samples/rCNVmap/data/master_annotations/genelists/Gencode_v19_protein_coding.genes.list
GO_cell_proliferation_genes	/data/talkowski/Samples/rCNVmap/data/master_annotations/genelists/GO_cell_proliferation.genes.list	/data/talkowski/Samples/rCNVmap/data/master_annotations/genelists/Gencode_v19_protein_coding.genes.list
GO_cell_division_genes	/data/talkowski/Samples/rCNVmap/data/master_annotations/genelists/GO_cell_division.genes.list	/data/talkowski/Samples/rCNVmap/data/master_annotations/genelists/Gencode_v19_protein_coding.genes.list
GO_cell_cycle_genes	/data/talkowski/Samples/rCNVmap/data/master_annotations/genelists/GO_cell_cycle.genes.list	/data/talkowski/Samples/rCNVmap/data/master_annotations/genelists/Gencode_v19_protein_coding.genes.list
GO_regulation_of_cell_proliferation_genes	/data/talkowski/Samples/rCNVmap/data/master_annotations/genelists/GO_regulation_of_cell_proliferation.genes.list	/data/talkowski/Samples/rCNVmap/data/master_annotations/genelists/Gencode_v19_protein_coding.genes.list
GO_dna_replication_genes	/data/talkowski/Samples/rCNVmap/data/master_annotations/genelists/GO_dna_replication.genes.list	/data/talkowski/Samples/rCNVmap/data/master_annotations/genelists/Gencode_v19_protein_coding.genes.list
GO_regulation_of_cell_cycle_genes	/data/talkowski/Samples/rCNVmap/data/master_annotations/genelists/GO_regulation_of_cell_cycle.genes.list	/data/talkowski/Samples/rCNVmap/data/master_annotations/genelists/Gencode_v19_protein_coding.genes.list
GO_cell_projection_genes	/data/talkowski/Samples/rCNVmap/data/master_annotations/genelists/GO_cell_projection.genes.list	/data/talkowski/Samples/rCNVmap/data/master_annotations/genelists/Gencode_v19_protein_coding.genes.list
GO_regulation_of_cell_growth_genes	/data/talkowski/Samples/rCNVmap/data/master_annotations/genelists/GO_regulation_of_cell_growth.genes.list	/data/talkowski/Samples/rCNVmap/data/master_annotations/genelists/Gencode_v19_protein_coding.genes.list
GO_cell_growth_genes	/data/talkowski/Samples/rCNVmap/data/master_annotations/genelists/GO_cell_growth.genes.list	/data/talkowski/Samples/rCNVmap/data/master_annotations/genelists/Gencode_v19_protein_coding.genes.list
GO_protein_phosphorylation_genes	/data/talkowski/Samples/rCNVmap/data/master_annotations/genelists/GO_protein_phosphorylation.genes.list	/data/talkowski/Samples/rCNVmap/data/master_annotations/genelists/Gencode_v19_protein_coding.genes.list
GO_protein_ubiquitination_genes	/data/talkowski/Samples/rCNVmap/data/master_annotations/genelists/GO_protein_ubiquitination.genes.list	/data/talkowski/Samples/rCNVmap/data/master_annotations/genelists/Gencode_v19_protein_coding.genes.list
GO_protein_kinase_activity_genes	/data/talkowski/Samples/rCNVmap/data/master_annotations/genelists/GO_protein_kinase_activity.genes.list	/data/talkowski/Samples/rCNVmap/data/master_annotations/genelists/Gencode_v19_protein_coding.genes.list
GO_dendrite_genes	/data/talkowski/Samples/rCNVmap/data/master_annotations/genelists/GO_dendrite.genes.list	/data/talkowski/Samples/rCNVmap/data/master_annotations/genelists/Gencode_v19_protein_coding.genes.list
GO_axon_genes	/data/talkowski/Samples/rCNVmap/data/master_annotations/genelists/GO_axon.genes.list	/data/talkowski/Samples/rCNVmap/data/master_annotations/genelists/Gencode_v19_protein_coding.genes.list
GO_neuron_projection_genes	/data/talkowski/Samples/rCNVmap/data/master_annotations/genelists/GO_neuron_projection.genes.list	/data/talkowski/Samples/rCNVmap/data/master_annotations/genelists/Gencode_v19_protein_coding.genes.list
GO_postsynaptic_density_genes	/data/talkowski/Samples/rCNVmap/data/master_annotations/genelists/GO_postsynaptic_density.genes.list	/data/talkowski/Samples/rCNVmap/data/master_annotations/genelists/Gencode_v19_protein_coding.genes.list
GO_axon_guidance_genes	/data/talkowski/Samples/rCNVmap/data/master_annotations/genelists/GO_axon_guidance.genes.list	/data/talkowski/Samples/rCNVmap/data/master_annotations/genelists/Gencode_v19_protein_coding.genes.list
GO_synapse_genes	/data/talkowski/Samples/rCNVmap/data/master_annotations/genelists/GO_synapse.genes.list	/data/talkowski/Samples/rCNVmap/data/master_annotations/genelists/Gencode_v19_protein_coding.genes.list
GO_neuron_projection_development_genes	/data/talkowski/Samples/rCNVmap/data/master_annotations/genelists/GO_neuron_projection_development.genes.list	/data/talkowski/Samples/rCNVmap/data/master_annotations/genelists/Gencode_v19_protein_coding.genes.list
GO_neuron_differentiation_genes	/data/talkowski/Samples/rCNVmap/data/master_annotations/genelists/GO_neuron_differentiation.genes.list	/data/talkowski/Samples/rCNVmap/data/master_annotations/genelists/Gencode_v19_protein_coding.genes.list
GO_axonogenesis_genes	/data/talkowski/Samples/rCNVmap/data/master_annotations/genelists/GO_axonogenesis.genes.list	/data/talkowski/Samples/rCNVmap/data/master_annotations/genelists/Gencode_v19_protein_coding.genes.list
GO_synapse_assembly_genes	/data/talkowski/Samples/rCNVmap/data/master_annotations/genelists/GO_synapse_assembly.genes.list	/data/talkowski/Samples/rCNVmap/data/master_annotations/genelists/Gencode_v19_protein_coding.genes.list
GO_presynaptic_membrane_genes	/data/talkowski/Samples/rCNVmap/data/master_annotations/genelists/GO_presynaptic_membrane.genes.list	/data/talkowski/Samples/rCNVmap/data/master_annotations/genelists/Gencode_v19_protein_coding.genes.list
GO_cerebral_cortex_development_genes	/data/talkowski/Samples/rCNVmap/data/master_annotations/genelists/GO_cerebral_cortex_development.genes.list	/data/talkowski/Samples/rCNVmap/data/master_annotations/genelists/Gencode_v19_protein_coding.genes.list
GO_ion_transport_genes	/data/talkowski/Samples/rCNVmap/data/master_annotations/genelists/GO_ion_transport.genes.list	/data/talkowski/Samples/rCNVmap/data/master_annotations/genelists/Gencode_v19_protein_coding.genes.list
GO_voltage_gated_potassium_channel_complex_genes	/data/talkowski/Samples/rCNVmap/data/master_annotations/genelists/GO_voltage_gated_potassium_channel_complex.genes.list	/data/talkowski/Samples/rCNVmap/data/master_annotations/genelists/Gencode_v19_protein_coding.genes.list
GO_sodium_ion_transmembrane_transport_genes	/data/talkowski/Samples/rCNVmap/data/master_annotations/genelists/GO_sodium_ion_transmembrane_transport.genes.list	/data/talkowski/Samples/rCNVmap/data/master_annotations/genelists/Gencode_v19_protein_coding.genes.list
GO_drug_binding_genes	/data/talkowski/Samples/rCNVmap/data/master_annotations/genelists/GO_drug_binding.genes.list	/data/talkowski/Samples/rCNVmap/data/master_annotations/genelists/Gencode_v19_protein_coding.genes.list
GO_somatic_stem_cell_population_maintenance_genes	/data/talkowski/Samples/rCNVmap/data/master_annotations/genelists/GO_somatic_stem_cell_population_maintenance.genes.list	/data/talkowski/Samples/rCNVmap/data/master_annotations/genelists/Gencode_v19_protein_coding.genes.list
GO_stem_cell_population_maintenance_genes	/data/talkowski/Samples/rCNVmap/data/master_annotations/genelists/GO_stem_cell_population_maintenance.genes.list	/data/talkowski/Samples/rCNVmap/data/master_annotations/genelists/Gencode_v19_protein_coding.genes.list
GO_immune_response_genes	/data/talkowski/Samples/rCNVmap/data/master_annotations/genelists/GO_immune_response.genes.list	/data/talkowski/Samples/rCNVmap/data/master_annotations/genelists/Gencode_v19_protein_coding.genes.list
GO_inflammatory_response_genes	/data/talkowski/Samples/rCNVmap/data/master_annotations/genelists/GO_inflammatory_response.genes.list	/data/talkowski/Samples/rCNVmap/data/master_annotations/genelists/Gencode_v19_protein_coding.genes.list
GO_nervous_system_development_genes	/data/talkowski/Samples/rCNVmap/data/master_annotations/genelists/GO_nervous_system_development.genes.list	/data/talkowski/Samples/rCNVmap/data/master_annotations/genelists/Gencode_v19_protein_coding.genes.list
GO_response_to_drug_genes	/data/talkowski/Samples/rCNVmap/data/master_annotations/genelists/GO_response_to_drug.genes.list	/data/talkowski/Samples/rCNVmap/data/master_annotations/genelists/Gencode_v19_protein_coding.genes.list
GO_brain_development_genes	/data/talkowski/Samples/rCNVmap/data/master_annotations/genelists/GO_brain_development.genes.list	/data/talkowski/Samples/rCNVmap/data/master_annotations/genelists/Gencode_v19_protein_coding.genes.list
GO_in_utero_embryonic_development_genes	/data/talkowski/Samples/rCNVmap/data/master_annotations/genelists/GO_in_utero_embryonic_development.genes.list	/data/talkowski/Samples/rCNVmap/data/master_annotations/genelists/Gencode_v19_protein_coding.genes.list
GO_heart_development_genes	/data/talkowski/Samples/rCNVmap/data/master_annotations/genelists/GO_heart_development.genes.list	/data/talkowski/Samples/rCNVmap/data/master_annotations/genelists/Gencode_v19_protein_coding.genes.list
GO_skeletal_system_development_genes	/data/talkowski/Samples/rCNVmap/data/master_annotations/genelists/GO_skeletal_system_development.genes.list	/data/talkowski/Samples/rCNVmap/data/master_annotations/genelists/Gencode_v19_protein_coding.genes.list
GO_muscle_contraction_genes	/data/talkowski/Samples/rCNVmap/data/master_annotations/genelists/GO_muscle_contraction.genes.list	/data/talkowski/Samples/rCNVmap/data/master_annotations/genelists/Gencode_v19_protein_coding.genes.list
GO_hormone_activity_genes	/data/talkowski/Samples/rCNVmap/data/master_annotations/genelists/GO_hormone_activity.genes.list	/data/talkowski/Samples/rCNVmap/data/master_annotations/genelists/Gencode_v19_protein_coding.genes.list
GO_complement_activation_genes	/data/talkowski/Samples/rCNVmap/data/master_annotations/genelists/GO_complement_activation.genes.list	/data/talkowski/Samples/rCNVmap/data/master_annotations/genelists/Gencode_v19_protein_coding.genes.list
GO_lung_development_genes	/data/talkowski/Samples/rCNVmap/data/master_annotations/genelists/GO_lung_development.genes.list	/data/talkowski/Samples/rCNVmap/data/master_annotations/genelists/Gencode_v19_protein_coding.genes.list
GO_post_embryonic_development_genes	/data/talkowski/Samples/rCNVmap/data/master_annotations/genelists/GO_post_embryonic_development.genes.list	/data/talkowski/Samples/rCNVmap/data/master_annotations/genelists/Gencode_v19_protein_coding.genes.list
GO_hematopoietic_progenitor_cell_differentiation_genes	/data/talkowski/Samples/rCNVmap/data/master_annotations/genelists/GO_hematopoietic_progenitor_cell_differentiation.genes.list	/data/talkowski/Samples/rCNVmap/data/master_annotations/genelists/Gencode_v19_protein_coding.genes.list
GO_cartilage_development_genes	/data/talkowski/Samples/rCNVmap/data/master_annotations/genelists/GO_cartilage_development.genes.list	/data/talkowski/Samples/rCNVmap/data/master_annotations/genelists/Gencode_v19_protein_coding.genes.list
GO_heart_looping_genes	/data/talkowski/Samples/rCNVmap/data/master_annotations/genelists/GO_heart_looping.genes.list	/data/talkowski/Samples/rCNVmap/data/master_annotations/genelists/Gencode_v19_protein_coding.genes.list
GO_regulation_of_cardiac_conduction_genes	/data/talkowski/Samples/rCNVmap/data/master_annotations/genelists/GO_regulation_of_cardiac_conduction.genes.list	/data/talkowski/Samples/rCNVmap/data/master_annotations/genelists/Gencode_v19_protein_coding.genes.list
GO_embryonic_digit_morphogenesis_genes	/data/talkowski/Samples/rCNVmap/data/master_annotations/genelists/GO_embryonic_digit_morphogenesis.genes.list	/data/talkowski/Samples/rCNVmap/data/master_annotations/genelists/Gencode_v19_protein_coding.genes.list
GO_adult_locomotory_behavior_genes	/data/talkowski/Samples/rCNVmap/data/master_annotations/genelists/GO_adult_locomotory_behavior.genes.list	/data/talkowski/Samples/rCNVmap/data/master_annotations/genelists/Gencode_v19_protein_coding.genes.list
GO_signal_transduction_genes	/data/talkowski/Samples/rCNVmap/data/master_annotations/genelists/GO_signal_transduction.genes.list	/data/talkowski/Samples/rCNVmap/data/master_annotations/genelists/Gencode_v19_protein_coding.genes.list
GO_cell_cell_signaling_genes	/data/talkowski/Samples/rCNVmap/data/master_annotations/genelists/GO_cell_cell_signaling.genes.list	/data/talkowski/Samples/rCNVmap/data/master_annotations/genelists/Gencode_v19_protein_coding.genes.list
GO_wnt_signaling_pathway_genes	/data/talkowski/Samples/rCNVmap/data/master_annotations/genelists/GO_wnt_signaling_pathway.genes.list	/data/talkowski/Samples/rCNVmap/data/master_annotations/genelists/Gencode_v19_protein_coding.genes.list
GO_cytokine_activity_genes	/data/talkowski/Samples/rCNVmap/data/master_annotations/genelists/GO_cytokine_activity.genes.list	/data/talkowski/Samples/rCNVmap/data/master_annotations/genelists/Gencode_v19_protein_coding.genes.list
GO_tumor_necrosis_factor_mediated_signaling_pathway_genes	/data/talkowski/Samples/rCNVmap/data/master_annotations/genelists/GO_tumor_necrosis_factor_mediated_signaling_pathway.genes.list	/data/talkowski/Samples/rCNVmap/data/master_annotations/genelists/Gencode_v19_protein_coding.genes.list
GO_notch_signaling_pathway_genes	/data/talkowski/Samples/rCNVmap/data/master_annotations/genelists/GO_notch_signaling_pathway.genes.list	/data/talkowski/Samples/rCNVmap/data/master_annotations/genelists/Gencode_v19_protein_coding.genes.list
GO_transforming_growth_factor_beta_receptor_signaling_pathway_genes	/data/talkowski/Samples/rCNVmap/data/master_annotations/genelists/GO_transforming_growth_factor_beta_receptor_signaling_pathway.genes.list	/data/talkowski/Samples/rCNVmap/data/master_annotations/genelists/Gencode_v19_protein_coding.genes.list
GO_b_cell_receptor_signaling_pathway_genes	/data/talkowski/Samples/rCNVmap/data/master_annotations/genelists/GO_b_cell_receptor_signaling_pathway.genes.list	/data/talkowski/Samples/rCNVmap/data/master_annotations/genelists/Gencode_v19_protein_coding.genes.list
GO_fibroblast_growth_factor_receptor_signaling_pathway_genes	/data/talkowski/Samples/rCNVmap/data/master_annotations/genelists/GO_fibroblast_growth_factor_receptor_signaling_pathway.genes.list	/data/talkowski/Samples/rCNVmap/data/master_annotations/genelists/Gencode_v19_protein_coding.genes.list
GO_bmp_signaling_pathway_genes	/data/talkowski/Samples/rCNVmap/data/master_annotations/genelists/GO_bmp_signaling_pathway.genes.list	/data/talkowski/Samples/rCNVmap/data/master_annotations/genelists/Gencode_v19_protein_coding.genes.list
GO_canonical_wnt_signaling_pathway_genes	/data/talkowski/Samples/rCNVmap/data/master_annotations/genelists/GO_canonical_wnt_signaling_pathway.genes.list	/data/talkowski/Samples/rCNVmap/data/master_annotations/genelists/Gencode_v19_protein_coding.genes.list
GO_interferon_gamma_mediated_signaling_pathway_genes	/data/talkowski/Samples/rCNVmap/data/master_annotations/genelists/GO_interferon_gamma_mediated_signaling_pathway.genes.list	/data/talkowski/Samples/rCNVmap/data/master_annotations/genelists/Gencode_v19_protein_coding.genes.list
GO_ras_protein_signal_transduction_genes	/data/talkowski/Samples/rCNVmap/data/master_annotations/genelists/GO_ras_protein_signal_transduction.genes.list	/data/talkowski/Samples/rCNVmap/data/master_annotations/genelists/Gencode_v19_protein_coding.genes.list
GO_Cell_cycle_and_growth_all_genes	/data/talkowski/Samples/rCNVmap/data/master_annotations/genelists/GO_Cell_cycle_and_growth_all.genes.list	/data/talkowski/Samples/rCNVmap/data/master_annotations/genelists/Gencode_v19_protein_coding.genes.list
GO_Core_cellular_process_all_genes	/data/talkowski/Samples/rCNVmap/data/master_annotations/genelists/GO_Core_cellular_process_all.genes.list	/data/talkowski/Samples/rCNVmap/data/master_annotations/genelists/Gencode_v19_protein_coding.genes.list
GO_Neurological_or_neuronal_function_all_genes	/data/talkowski/Samples/rCNVmap/data/master_annotations/genelists/GO_Neurological_or_neuronal_function_all.genes.list	/data/talkowski/Samples/rCNVmap/data/master_annotations/genelists/Gencode_v19_protein_coding.genes.list
GO_Physiology_or_development_all_genes	/data/talkowski/Samples/rCNVmap/data/master_annotations/genelists/GO_Physiology_or_development_all.genes.list	/data/talkowski/Samples/rCNVmap/data/master_annotations/genelists/Gencode_v19_protein_coding.genes.list
GO_Protein_modification_all_genes	/data/talkowski/Samples/rCNVmap/data/master_annotations/genelists/GO_Protein_modification_all.genes.list	/data/talkowski/Samples/rCNVmap/data/master_annotations/genelists/Gencode_v19_protein_coding.genes.list
GO_Signalling_all_genes	/data/talkowski/Samples/rCNVmap/data/master_annotations/genelists/GO_Signalling_all.genes.list	/data/talkowski/Samples/rCNVmap/data/master_annotations/genelists/Gencode_v19_protein_coding.genes.list
GO_Transcriptional_regulation_and_chromatin_all_genes	/data/talkowski/Samples/rCNVmap/data/master_annotations/genelists/GO_Transcriptional_regulation_and_chromatin_all.genes.list	/data/talkowski/Samples/rCNVmap/data/master_annotations/genelists/Gencode_v19_protein_coding.genes.list
Developmental_disorder_associated_genes	/data/talkowski/Samples/rCNVmap/data/master_annotations/genelists/DDD_2017.genes.list	/data/talkowski/Samples/rCNVmap/data/master_annotations/genelists/Gencode_v19_protein_coding.genes.list
CHD8_target_genes	/data/talkowski/Samples/rCNVmap/data/master_annotations/genelists/CHD8_targets.genes.list	/data/talkowski/Samples/rCNVmap/data/master_annotations/genelists/Gencode_v19_protein_coding.genes.list
ASD_associated_genes_TADA_q0.1	/data/talkowski/Samples/rCNVmap/data/master_annotations/genelists/ASD_TADA_q0.1.genes.list	/data/talkowski/Samples/rCNVmap/data/master_annotations/genelists/Gencode_v19_protein_coding.genes.list
ASD_associated_genes_TADA_q0.3	/data/talkowski/Samples/rCNVmap/data/master_annotations/genelists/ASD_TADA_q0.3.genes.list	/data/talkowski/Samples/rCNVmap/data/master_annotations/genelists/Gencode_v19_protein_coding.genes.list
ASD_associated_genes_DAWN	/data/talkowski/Samples/rCNVmap/data/master_annotations/genelists/ASD_DAWN.genes.list	/data/talkowski/Samples/rCNVmap/data/master_annotations/genelists/Gencode_v19_protein_coding.genes.list
ASD_associated_genes_exome_DNMs	/data/talkowski/Samples/rCNVmap/data/master_annotations/genelists/ASD_WES_DNM.genes.list	/data/talkowski/Samples/rCNVmap/data/master_annotations/genelists/Gencode_v19_protein_coding.genes.list
ASD_associated_genes_brain_expression_networks	/data/talkowski/Samples/rCNVmap/data/master_annotations/genelists/ASD_BrainExpressionNetworks.genes.list	/data/talkowski/Samples/rCNVmap/data/master_annotations/genelists/Gencode_v19_protein_coding.genes.list
ASD_associated_genes_SFARIGene	/data/talkowski/Samples/rCNVmap/data/master_annotations/genelists/ASD_SFARIGene.genes.list	/data/talkowski/Samples/rCNVmap/data/master_annotations/genelists/Gencode_v19_protein_coding.genes.list
RBFOX1_target_genes	/data/talkowski/Samples/rCNVmap/data/master_annotations/genelists/RBFOX1_targets.genes.list	/data/talkowski/Samples/rCNVmap/data/master_annotations/genelists/Gencode_v19_protein_coding.genes.list
COSMIC_oncogenes	/data/talkowski/Samples/rCNVmap/data/master_annotations/genelists/COSMIC_oncogene.genes.list	/data/talkowski/Samples/rCNVmap/data/master_annotations/genelists/Gencode_v19_protein_coding.genes.list
COSMIC_cancer_genes	/data/talkowski/Samples/rCNVmap/data/master_annotations/genelists/COSMIC_all.genes.list	/data/talkowski/Samples/rCNVmap/data/master_annotations/genelists/Gencode_v19_protein_coding.genes.list
COSMIC_tumor_suppressor_genes	/data/talkowski/Samples/rCNVmap/data/master_annotations/genelists/COSMIC_tumor_suppressor.genes.list	/data/talkowski/Samples/rCNVmap/data/master_annotations/genelists/Gencode_v19_protein_coding.genes.list
Schizophrenia_associated_genes_PGC_GWAS	/data/talkowski/Samples/rCNVmap/data/master_annotations/genelists/Schizophrenia_GWAS.genes.list	/data/talkowski/Samples/rCNVmap/data/master_annotations/genelists/Gencode_v19_protein_coding.genes.list
BRAIN_highly_expressed_genes_union	/data/talkowski/Samples/rCNVmap/data/master_annotations/genelists/BRAIN_MASTER_UNION.Highly_Expressed.genes.list	/data/talkowski/Samples/rCNVmap/data/master_annotations/genelists/Gencode_v19_protein_coding.genes.list
BRAIN_highly_expressed_genes_intersection	/data/talkowski/Samples/rCNVmap/data/master_annotations/genelists/BRAIN_MASTER_INTERSECTION.Highly_Expressed.genes.list	/data/talkowski/Samples/rCNVmap/data/master_annotations/genelists/Gencode_v19_protein_coding.genes.list
BRAIN_not_expressed_genes_union	/data/talkowski/Samples/rCNVmap/data/master_annotations/genelists/BRAIN_MASTER_UNION.Not_Expressed.genes.list	/data/talkowski/Samples/rCNVmap/data/master_annotations/genelists/Gencode_v19_protein_coding.genes.list
BRAIN_not_expressed_genes_intersection	/data/talkowski/Samples/rCNVmap/data/master_annotations/genelists/BRAIN_MASTER_INTERSECTION.Not_Expressed.genes.list	/data/talkowski/Samples/rCNVmap/data/master_annotations/genelists/Gencode_v19_protein_coding.genes.list
BRAIN_specifically_expressed_genes_union	/data/talkowski/Samples/rCNVmap/data/master_annotations/genelists/BRAIN_MASTER_UNION.Preferentially_Expressed.genes.list	/data/talkowski/Samples/rCNVmap/data/master_annotations/genelists/Gencode_v19_protein_coding.genes.list
BRAIN_very_highly_expressed_genes_union	/data/talkowski/Samples/rCNVmap/data/master_annotations/genelists/BRAIN_MASTER_UNION.Very_Highly_Expressed.genes.list	/data/talkowski/Samples/rCNVmap/data/master_annotations/genelists/Gencode_v19_protein_coding.genes.list
BRAIN_very_highly_expressed_genes_intersection	/data/talkowski/Samples/rCNVmap/data/master_annotations/genelists/BRAIN_MASTER_INTERSECTION.Very_Highly_Expressed.genes.list	/data/talkowski/Samples/rCNVmap/data/master_annotations/genelists/Gencode_v19_protein_coding.genes.list
CELLLINE_highly_expressed_genes_union	/data/talkowski/Samples/rCNVmap/data/master_annotations/genelists/CELLLINE_MASTER_UNION.Highly_Expressed.genes.list	/data/talkowski/Samples/rCNVmap/data/master_annotations/genelists/Gencode_v19_protein_coding.genes.list
CELLLINE_highly_expressed_genes_intersection	/data/talkowski/Samples/rCNVmap/data/master_annotations/genelists/CELLLINE_MASTER_INTERSECTION.Highly_Expressed.genes.list	/data/talkowski/Samples/rCNVmap/data/master_annotations/genelists/Gencode_v19_protein_coding.genes.list
CELLLINE_not_expressed_genes_union	/data/talkowski/Samples/rCNVmap/data/master_annotations/genelists/CELLLINE_MASTER_UNION.Not_Expressed.genes.list	/data/talkowski/Samples/rCNVmap/data/master_annotations/genelists/Gencode_v19_protein_coding.genes.list
CELLLINE_not_expressed_genes_intersection	/data/talkowski/Samples/rCNVmap/data/master_annotations/genelists/CELLLINE_MASTER_INTERSECTION.Not_Expressed.genes.list	/data/talkowski/Samples/rCNVmap/data/master_annotations/genelists/Gencode_v19_protein_coding.genes.list
CELLLINE_specifically_expressed_genes_union	/data/talkowski/Samples/rCNVmap/data/master_annotations/genelists/CELLLINE_MASTER_UNION.Preferentially_Expressed.genes.list	/data/talkowski/Samples/rCNVmap/data/master_annotations/genelists/Gencode_v19_protein_coding.genes.list
CELLLINE_very_highly_expressed_genes_union	/data/talkowski/Samples/rCNVmap/data/master_annotations/genelists/CELLLINE_MASTER_UNION.Very_Highly_Expressed.genes.list	/data/talkowski/Samples/rCNVmap/data/master_annotations/genelists/Gencode_v19_protein_coding.genes.list
CELLLINE_very_highly_expressed_genes_intersection	/data/talkowski/Samples/rCNVmap/data/master_annotations/genelists/CELLLINE_MASTER_INTERSECTION.Very_Highly_Expressed.genes.list	/data/talkowski/Samples/rCNVmap/data/master_annotations/genelists/Gencode_v19_protein_coding.genes.list
DIGESTIVE_highly_expressed_genes_union	/data/talkowski/Samples/rCNVmap/data/master_annotations/genelists/DIGESTIVE_MASTER_UNION.Highly_Expressed.genes.list	/data/talkowski/Samples/rCNVmap/data/master_annotations/genelists/Gencode_v19_protein_coding.genes.list
DIGESTIVE_highly_expressed_genes_intersection	/data/talkowski/Samples/rCNVmap/data/master_annotations/genelists/DIGESTIVE_MASTER_INTERSECTION.Highly_Expressed.genes.list	/data/talkowski/Samples/rCNVmap/data/master_annotations/genelists/Gencode_v19_protein_coding.genes.list
DIGESTIVE_not_expressed_genes_union	/data/talkowski/Samples/rCNVmap/data/master_annotations/genelists/DIGESTIVE_MASTER_UNION.Not_Expressed.genes.list	/data/talkowski/Samples/rCNVmap/data/master_annotations/genelists/Gencode_v19_protein_coding.genes.list
DIGESTIVE_not_expressed_genes_intersection	/data/talkowski/Samples/rCNVmap/data/master_annotations/genelists/DIGESTIVE_MASTER_INTERSECTION.Not_Expressed.genes.list	/data/talkowski/Samples/rCNVmap/data/master_annotations/genelists/Gencode_v19_protein_coding.genes.list
DIGESTIVE_specifically_expressed_genes_union	/data/talkowski/Samples/rCNVmap/data/master_annotations/genelists/DIGESTIVE_MASTER_UNION.Preferentially_Expressed.genes.list	/data/talkowski/Samples/rCNVmap/data/master_annotations/genelists/Gencode_v19_protein_coding.genes.list
DIGESTIVE_very_highly_expressed_genes_union	/data/talkowski/Samples/rCNVmap/data/master_annotations/genelists/DIGESTIVE_MASTER_UNION.Very_Highly_Expressed.genes.list	/data/talkowski/Samples/rCNVmap/data/master_annotations/genelists/Gencode_v19_protein_coding.genes.list
DIGESTIVE_very_highly_expressed_genes_intersection	/data/talkowski/Samples/rCNVmap/data/master_annotations/genelists/DIGESTIVE_MASTER_INTERSECTION.Very_Highly_Expressed.genes.list	/data/talkowski/Samples/rCNVmap/data/master_annotations/genelists/Gencode_v19_protein_coding.genes.list
ENDOCRINE_highly_expressed_genes_union	/data/talkowski/Samples/rCNVmap/data/master_annotations/genelists/ENDOCRINE_MASTER_UNION.Highly_Expressed.genes.list	/data/talkowski/Samples/rCNVmap/data/master_annotations/genelists/Gencode_v19_protein_coding.genes.list
ENDOCRINE_highly_expressed_genes_intersection	/data/talkowski/Samples/rCNVmap/data/master_annotations/genelists/ENDOCRINE_MASTER_INTERSECTION.Highly_Expressed.genes.list	/data/talkowski/Samples/rCNVmap/data/master_annotations/genelists/Gencode_v19_protein_coding.genes.list
ENDOCRINE_not_expressed_genes_union	/data/talkowski/Samples/rCNVmap/data/master_annotations/genelists/ENDOCRINE_MASTER_UNION.Not_Expressed.genes.list	/data/talkowski/Samples/rCNVmap/data/master_annotations/genelists/Gencode_v19_protein_coding.genes.list
ENDOCRINE_not_expressed_genes_intersection	/data/talkowski/Samples/rCNVmap/data/master_annotations/genelists/ENDOCRINE_MASTER_INTERSECTION.Not_Expressed.genes.list	/data/talkowski/Samples/rCNVmap/data/master_annotations/genelists/Gencode_v19_protein_coding.genes.list
ENDOCRINE_specifically_expressed_genes_union	/data/talkowski/Samples/rCNVmap/data/master_annotations/genelists/ENDOCRINE_MASTER_UNION.Preferentially_Expressed.genes.list	/data/talkowski/Samples/rCNVmap/data/master_annotations/genelists/Gencode_v19_protein_coding.genes.list
ENDOCRINE_very_highly_expressed_genes_union	/data/talkowski/Samples/rCNVmap/data/master_annotations/genelists/ENDOCRINE_MASTER_UNION.Very_Highly_Expressed.genes.list	/data/talkowski/Samples/rCNVmap/data/master_annotations/genelists/Gencode_v19_protein_coding.genes.list
ENDOCRINE_very_highly_expressed_genes_intersection	/data/talkowski/Samples/rCNVmap/data/master_annotations/genelists/ENDOCRINE_MASTER_INTERSECTION.Very_Highly_Expressed.genes.list	/data/talkowski/Samples/rCNVmap/data/master_annotations/genelists/Gencode_v19_protein_coding.genes.list
FAT_highly_expressed_genes_union	/data/talkowski/Samples/rCNVmap/data/master_annotations/genelists/FAT_MASTER_UNION.Highly_Expressed.genes.list	/data/talkowski/Samples/rCNVmap/data/master_annotations/genelists/Gencode_v19_protein_coding.genes.list
FAT_highly_expressed_genes_intersection	/data/talkowski/Samples/rCNVmap/data/master_annotations/genelists/FAT_MASTER_INTERSECTION.Highly_Expressed.genes.list	/data/talkowski/Samples/rCNVmap/data/master_annotations/genelists/Gencode_v19_protein_coding.genes.list
FAT_not_expressed_genes_union	/data/talkowski/Samples/rCNVmap/data/master_annotations/genelists/FAT_MASTER_UNION.Not_Expressed.genes.list	/data/talkowski/Samples/rCNVmap/data/master_annotations/genelists/Gencode_v19_protein_coding.genes.list
FAT_not_expressed_genes_intersection	/data/talkowski/Samples/rCNVmap/data/master_annotations/genelists/FAT_MASTER_INTERSECTION.Not_Expressed.genes.list	/data/talkowski/Samples/rCNVmap/data/master_annotations/genelists/Gencode_v19_protein_coding.genes.list
FAT_specifically_expressed_genes_union	/data/talkowski/Samples/rCNVmap/data/master_annotations/genelists/FAT_MASTER_UNION.Preferentially_Expressed.genes.list	/data/talkowski/Samples/rCNVmap/data/master_annotations/genelists/Gencode_v19_protein_coding.genes.list
FAT_very_highly_expressed_genes_union	/data/talkowski/Samples/rCNVmap/data/master_annotations/genelists/FAT_MASTER_UNION.Very_Highly_Expressed.genes.list	/data/talkowski/Samples/rCNVmap/data/master_annotations/genelists/Gencode_v19_protein_coding.genes.list
FAT_very_highly_expressed_genes_intersection	/data/talkowski/Samples/rCNVmap/data/master_annotations/genelists/FAT_MASTER_INTERSECTION.Very_Highly_Expressed.genes.list	/data/talkowski/Samples/rCNVmap/data/master_annotations/genelists/Gencode_v19_protein_coding.genes.list
HEADNECK_highly_expressed_genes_union	/data/talkowski/Samples/rCNVmap/data/master_annotations/genelists/HEADNECK_MASTER_UNION.Highly_Expressed.genes.list	/data/talkowski/Samples/rCNVmap/data/master_annotations/genelists/Gencode_v19_protein_coding.genes.list
HEADNECK_highly_expressed_genes_intersection	/data/talkowski/Samples/rCNVmap/data/master_annotations/genelists/HEADNECK_MASTER_INTERSECTION.Highly_Expressed.genes.list	/data/talkowski/Samples/rCNVmap/data/master_annotations/genelists/Gencode_v19_protein_coding.genes.list
HEADNECK_not_expressed_genes_union	/data/talkowski/Samples/rCNVmap/data/master_annotations/genelists/HEADNECK_MASTER_UNION.Not_Expressed.genes.list	/data/talkowski/Samples/rCNVmap/data/master_annotations/genelists/Gencode_v19_protein_coding.genes.list
HEADNECK_not_expressed_genes_intersection	/data/talkowski/Samples/rCNVmap/data/master_annotations/genelists/HEADNECK_MASTER_INTERSECTION.Not_Expressed.genes.list	/data/talkowski/Samples/rCNVmap/data/master_annotations/genelists/Gencode_v19_protein_coding.genes.list
HEADNECK_specifically_expressed_genes_union	/data/talkowski/Samples/rCNVmap/data/master_annotations/genelists/HEADNECK_MASTER_UNION.Preferentially_Expressed.genes.list	/data/talkowski/Samples/rCNVmap/data/master_annotations/genelists/Gencode_v19_protein_coding.genes.list
HEADNECK_very_highly_expressed_genes_union	/data/talkowski/Samples/rCNVmap/data/master_annotations/genelists/HEADNECK_MASTER_UNION.Very_Highly_Expressed.genes.list	/data/talkowski/Samples/rCNVmap/data/master_annotations/genelists/Gencode_v19_protein_coding.genes.list
HEADNECK_very_highly_expressed_genes_intersection	/data/talkowski/Samples/rCNVmap/data/master_annotations/genelists/HEADNECK_MASTER_INTERSECTION.Very_Highly_Expressed.genes.list	/data/talkowski/Samples/rCNVmap/data/master_annotations/genelists/Gencode_v19_protein_coding.genes.list
HEART_highly_expressed_genes_union	/data/talkowski/Samples/rCNVmap/data/master_annotations/genelists/HEART_MASTER_UNION.Highly_Expressed.genes.list	/data/talkowski/Samples/rCNVmap/data/master_annotations/genelists/Gencode_v19_protein_coding.genes.list
HEART_highly_expressed_genes_intersection	/data/talkowski/Samples/rCNVmap/data/master_annotations/genelists/HEART_MASTER_INTERSECTION.Highly_Expressed.genes.list	/data/talkowski/Samples/rCNVmap/data/master_annotations/genelists/Gencode_v19_protein_coding.genes.list
HEART_not_expressed_genes_union	/data/talkowski/Samples/rCNVmap/data/master_annotations/genelists/HEART_MASTER_UNION.Not_Expressed.genes.list	/data/talkowski/Samples/rCNVmap/data/master_annotations/genelists/Gencode_v19_protein_coding.genes.list
HEART_not_expressed_genes_intersection	/data/talkowski/Samples/rCNVmap/data/master_annotations/genelists/HEART_MASTER_INTERSECTION.Not_Expressed.genes.list	/data/talkowski/Samples/rCNVmap/data/master_annotations/genelists/Gencode_v19_protein_coding.genes.list
HEART_specifically_expressed_genes_union	/data/talkowski/Samples/rCNVmap/data/master_annotations/genelists/HEART_MASTER_UNION.Preferentially_Expressed.genes.list	/data/talkowski/Samples/rCNVmap/data/master_annotations/genelists/Gencode_v19_protein_coding.genes.list
HEART_very_highly_expressed_genes_union	/data/talkowski/Samples/rCNVmap/data/master_annotations/genelists/HEART_MASTER_UNION.Very_Highly_Expressed.genes.list	/data/talkowski/Samples/rCNVmap/data/master_annotations/genelists/Gencode_v19_protein_coding.genes.list
HEART_very_highly_expressed_genes_intersection	/data/talkowski/Samples/rCNVmap/data/master_annotations/genelists/HEART_MASTER_INTERSECTION.Very_Highly_Expressed.genes.list	/data/talkowski/Samples/rCNVmap/data/master_annotations/genelists/Gencode_v19_protein_coding.genes.list
IMMUNE_highly_expressed_genes_union	/data/talkowski/Samples/rCNVmap/data/master_annotations/genelists/IMMUNE_MASTER_UNION.Highly_Expressed.genes.list	/data/talkowski/Samples/rCNVmap/data/master_annotations/genelists/Gencode_v19_protein_coding.genes.list
IMMUNE_highly_expressed_genes_intersection	/data/talkowski/Samples/rCNVmap/data/master_annotations/genelists/IMMUNE_MASTER_INTERSECTION.Highly_Expressed.genes.list	/data/talkowski/Samples/rCNVmap/data/master_annotations/genelists/Gencode_v19_protein_coding.genes.list
IMMUNE_not_expressed_genes_union	/data/talkowski/Samples/rCNVmap/data/master_annotations/genelists/IMMUNE_MASTER_UNION.Not_Expressed.genes.list	/data/talkowski/Samples/rCNVmap/data/master_annotations/genelists/Gencode_v19_protein_coding.genes.list
IMMUNE_not_expressed_genes_intersection	/data/talkowski/Samples/rCNVmap/data/master_annotations/genelists/IMMUNE_MASTER_INTERSECTION.Not_Expressed.genes.list	/data/talkowski/Samples/rCNVmap/data/master_annotations/genelists/Gencode_v19_protein_coding.genes.list
IMMUNE_specifically_expressed_genes_union	/data/talkowski/Samples/rCNVmap/data/master_annotations/genelists/IMMUNE_MASTER_UNION.Preferentially_Expressed.genes.list	/data/talkowski/Samples/rCNVmap/data/master_annotations/genelists/Gencode_v19_protein_coding.genes.list
IMMUNE_very_highly_expressed_genes_union	/data/talkowski/Samples/rCNVmap/data/master_annotations/genelists/IMMUNE_MASTER_UNION.Very_Highly_Expressed.genes.list	/data/talkowski/Samples/rCNVmap/data/master_annotations/genelists/Gencode_v19_protein_coding.genes.list
IMMUNE_very_highly_expressed_genes_intersection	/data/talkowski/Samples/rCNVmap/data/master_annotations/genelists/IMMUNE_MASTER_INTERSECTION.Very_Highly_Expressed.genes.list	/data/talkowski/Samples/rCNVmap/data/master_annotations/genelists/Gencode_v19_protein_coding.genes.list
LUNG_highly_expressed_genes_union	/data/talkowski/Samples/rCNVmap/data/master_annotations/genelists/LUNG_MASTER_UNION.Highly_Expressed.genes.list	/data/talkowski/Samples/rCNVmap/data/master_annotations/genelists/Gencode_v19_protein_coding.genes.list
LUNG_highly_expressed_genes_intersection	/data/talkowski/Samples/rCNVmap/data/master_annotations/genelists/LUNG_MASTER_INTERSECTION.Highly_Expressed.genes.list	/data/talkowski/Samples/rCNVmap/data/master_annotations/genelists/Gencode_v19_protein_coding.genes.list
LUNG_not_expressed_genes_union	/data/talkowski/Samples/rCNVmap/data/master_annotations/genelists/LUNG_MASTER_UNION.Not_Expressed.genes.list	/data/talkowski/Samples/rCNVmap/data/master_annotations/genelists/Gencode_v19_protein_coding.genes.list
LUNG_not_expressed_genes_intersection	/data/talkowski/Samples/rCNVmap/data/master_annotations/genelists/LUNG_MASTER_INTERSECTION.Not_Expressed.genes.list	/data/talkowski/Samples/rCNVmap/data/master_annotations/genelists/Gencode_v19_protein_coding.genes.list
LUNG_specifically_expressed_genes_union	/data/talkowski/Samples/rCNVmap/data/master_annotations/genelists/LUNG_MASTER_UNION.Preferentially_Expressed.genes.list	/data/talkowski/Samples/rCNVmap/data/master_annotations/genelists/Gencode_v19_protein_coding.genes.list
LUNG_very_highly_expressed_genes_union	/data/talkowski/Samples/rCNVmap/data/master_annotations/genelists/LUNG_MASTER_UNION.Very_Highly_Expressed.genes.list	/data/talkowski/Samples/rCNVmap/data/master_annotations/genelists/Gencode_v19_protein_coding.genes.list
LUNG_very_highly_expressed_genes_intersection	/data/talkowski/Samples/rCNVmap/data/master_annotations/genelists/LUNG_MASTER_INTERSECTION.Very_Highly_Expressed.genes.list	/data/talkowski/Samples/rCNVmap/data/master_annotations/genelists/Gencode_v19_protein_coding.genes.list
MUSCLE_highly_expressed_genes_union	/data/talkowski/Samples/rCNVmap/data/master_annotations/genelists/MUSCLE_MASTER_UNION.Highly_Expressed.genes.list	/data/talkowski/Samples/rCNVmap/data/master_annotations/genelists/Gencode_v19_protein_coding.genes.list
MUSCLE_highly_expressed_genes_intersection	/data/talkowski/Samples/rCNVmap/data/master_annotations/genelists/MUSCLE_MASTER_INTERSECTION.Highly_Expressed.genes.list	/data/talkowski/Samples/rCNVmap/data/master_annotations/genelists/Gencode_v19_protein_coding.genes.list
MUSCLE_not_expressed_genes_union	/data/talkowski/Samples/rCNVmap/data/master_annotations/genelists/MUSCLE_MASTER_UNION.Not_Expressed.genes.list	/data/talkowski/Samples/rCNVmap/data/master_annotations/genelists/Gencode_v19_protein_coding.genes.list
MUSCLE_not_expressed_genes_intersection	/data/talkowski/Samples/rCNVmap/data/master_annotations/genelists/MUSCLE_MASTER_INTERSECTION.Not_Expressed.genes.list	/data/talkowski/Samples/rCNVmap/data/master_annotations/genelists/Gencode_v19_protein_coding.genes.list
MUSCLE_specifically_expressed_genes_union	/data/talkowski/Samples/rCNVmap/data/master_annotations/genelists/MUSCLE_MASTER_UNION.Preferentially_Expressed.genes.list	/data/talkowski/Samples/rCNVmap/data/master_annotations/genelists/Gencode_v19_protein_coding.genes.list
MUSCLE_very_highly_expressed_genes_union	/data/talkowski/Samples/rCNVmap/data/master_annotations/genelists/MUSCLE_MASTER_UNION.Very_Highly_Expressed.genes.list	/data/talkowski/Samples/rCNVmap/data/master_annotations/genelists/Gencode_v19_protein_coding.genes.list
MUSCLE_very_highly_expressed_genes_intersection	/data/talkowski/Samples/rCNVmap/data/master_annotations/genelists/MUSCLE_MASTER_INTERSECTION.Very_Highly_Expressed.genes.list	/data/talkowski/Samples/rCNVmap/data/master_annotations/genelists/Gencode_v19_protein_coding.genes.list
RENAL_highly_expressed_genes_union	/data/talkowski/Samples/rCNVmap/data/master_annotations/genelists/RENAL_MASTER_UNION.Highly_Expressed.genes.list	/data/talkowski/Samples/rCNVmap/data/master_annotations/genelists/Gencode_v19_protein_coding.genes.list
RENAL_highly_expressed_genes_intersection	/data/talkowski/Samples/rCNVmap/data/master_annotations/genelists/RENAL_MASTER_INTERSECTION.Highly_Expressed.genes.list	/data/talkowski/Samples/rCNVmap/data/master_annotations/genelists/Gencode_v19_protein_coding.genes.list
RENAL_not_expressed_genes_union	/data/talkowski/Samples/rCNVmap/data/master_annotations/genelists/RENAL_MASTER_UNION.Not_Expressed.genes.list	/data/talkowski/Samples/rCNVmap/data/master_annotations/genelists/Gencode_v19_protein_coding.genes.list
RENAL_not_expressed_genes_intersection	/data/talkowski/Samples/rCNVmap/data/master_annotations/genelists/RENAL_MASTER_INTERSECTION.Not_Expressed.genes.list	/data/talkowski/Samples/rCNVmap/data/master_annotations/genelists/Gencode_v19_protein_coding.genes.list
RENAL_very_highly_expressed_genes_union	/data/talkowski/Samples/rCNVmap/data/master_annotations/genelists/RENAL_MASTER_UNION.Very_Highly_Expressed.genes.list	/data/talkowski/Samples/rCNVmap/data/master_annotations/genelists/Gencode_v19_protein_coding.genes.list
REPRO_very_highly_expressed_genes_intersection	/data/talkowski/Samples/rCNVmap/data/master_annotations/genelists/RENAL_MASTER_INTERSECTION.Very_Highly_Expressed.genes.list	/data/talkowski/Samples/rCNVmap/data/master_annotations/genelists/Gencode_v19_protein_coding.genes.list
REPRO_highly_expressed_genes_union	/data/talkowski/Samples/rCNVmap/data/master_annotations/genelists/REPRO_MASTER_UNION.Highly_Expressed.genes.list	/data/talkowski/Samples/rCNVmap/data/master_annotations/genelists/Gencode_v19_protein_coding.genes.list
REPRO_highly_expressed_genes_intersection	/data/talkowski/Samples/rCNVmap/data/master_annotations/genelists/REPRO_MASTER_INTERSECTION.Highly_Expressed.genes.list	/data/talkowski/Samples/rCNVmap/data/master_annotations/genelists/Gencode_v19_protein_coding.genes.list
REPRO_not_expressed_genes_union	/data/talkowski/Samples/rCNVmap/data/master_annotations/genelists/REPRO_MASTER_UNION.Not_Expressed.genes.list	/data/talkowski/Samples/rCNVmap/data/master_annotations/genelists/Gencode_v19_protein_coding.genes.list
REPRO_not_expressed_genes_intersection	/data/talkowski/Samples/rCNVmap/data/master_annotations/genelists/REPRO_MASTER_INTERSECTION.Not_Expressed.genes.list	/data/talkowski/Samples/rCNVmap/data/master_annotations/genelists/Gencode_v19_protein_coding.genes.list
REPRO_specifically_expressed_genes_union	/data/talkowski/Samples/rCNVmap/data/master_annotations/genelists/REPRO_MASTER_UNION.Preferentially_Expressed.genes.list	/data/talkowski/Samples/rCNVmap/data/master_annotations/genelists/Gencode_v19_protein_coding.genes.list
REPRO_very_highly_expressed_genes_union	/data/talkowski/Samples/rCNVmap/data/master_annotations/genelists/REPRO_MASTER_UNION.Very_Highly_Expressed.genes.list	/data/talkowski/Samples/rCNVmap/data/master_annotations/genelists/Gencode_v19_protein_coding.genes.list
REPRO_very_highly_expressed_genes_intersection	/data/talkowski/Samples/rCNVmap/data/master_annotations/genelists/REPRO_MASTER_INTERSECTION.Very_Highly_Expressed.genes.list	/data/talkowski/Samples/rCNVmap/data/master_annotations/genelists/Gencode_v19_protein_coding.genes.list
SKIN_highly_expressed_genes_union	/data/talkowski/Samples/rCNVmap/data/master_annotations/genelists/SKIN_MASTER_UNION.Highly_Expressed.genes.list	/data/talkowski/Samples/rCNVmap/data/master_annotations/genelists/Gencode_v19_protein_coding.genes.list
SKIN_highly_expressed_genes_intersection	/data/talkowski/Samples/rCNVmap/data/master_annotations/genelists/SKIN_MASTER_INTERSECTION.Highly_Expressed.genes.list	/data/talkowski/Samples/rCNVmap/data/master_annotations/genelists/Gencode_v19_protein_coding.genes.list
SKIN_not_expressed_genes_union	/data/talkowski/Samples/rCNVmap/data/master_annotations/genelists/SKIN_MASTER_UNION.Not_Expressed.genes.list	/data/talkowski/Samples/rCNVmap/data/master_annotations/genelists/Gencode_v19_protein_coding.genes.list
SKIN_not_expressed_genes_intersection	/data/talkowski/Samples/rCNVmap/data/master_annotations/genelists/SKIN_MASTER_INTERSECTION.Not_Expressed.genes.list	/data/talkowski/Samples/rCNVmap/data/master_annotations/genelists/Gencode_v19_protein_coding.genes.list
SKIN_specifically_expressed_genes_union	/data/talkowski/Samples/rCNVmap/data/master_annotations/genelists/SKIN_MASTER_UNION.Preferentially_Expressed.genes.list	/data/talkowski/Samples/rCNVmap/data/master_annotations/genelists/Gencode_v19_protein_coding.genes.list
SKIN_very_highly_expressed_genes_union	/data/talkowski/Samples/rCNVmap/data/master_annotations/genelists/SKIN_MASTER_UNION.Very_Highly_Expressed.genes.list	/data/talkowski/Samples/rCNVmap/data/master_annotations/genelists/Gencode_v19_protein_coding.genes.list
SKIN_very_highly_expressed_genes_intersection	/data/talkowski/Samples/rCNVmap/data/master_annotations/genelists/SKIN_MASTER_INTERSECTION.Very_Highly_Expressed.genes.list	/data/talkowski/Samples/rCNVmap/data/master_annotations/genelists/Gencode_v19_protein_coding.genes.list